,GeoFips,GeoName,year,MEDINC,MEDVAL,MOE,UMEDVAL,LMEDVAL,PERINC,POP,RPPALL,RPPGOODS,RPPRENT,RPPSOTH,IPD
1,10180,"Abilene, TX (Metropolitan Statistical Area)",2019,45552,116100,2841,118941,113259,7837655,172060,90.3,96,80.1,91.2,98.3
2,10420,"Akron, OH (Metropolitan Statistical Area)",2019,51095,150000,1449,151449,148551,35944121,703479,90,95.9,76.2,92.2,98
3,10500,"Albany, GA (Metropolitan Statistical Area)",2019,39922,117700,2736,120436,114964,5857583,146726,82.8,96,51.7,95.1,90.2
4,10540,"Albany-Lebanon, OR (Metropolitan Statistical Area)",2019,44830,221600,4836,226436,216764,5816653,129749,98,102.8,90.4,97.7,106.7
5,10580,"Albany-Schenectady-Troy, NY (Metropolitan Statistical Area)",2019,60767,213600,1557,215157,212043,53498359,880381,99.3,98.9,102.8,97.9,108.1
6,10740,"Albuquerque, NM (Metropolitan Statistical Area) *",2019,43986,192800,1440,194240,191360,40379815,918018,93.6,93.1,87.8,99.1,101.9
7,10780,"Alexandria, LA (Metropolitan Statistical Area)",2019,44446,136200,4978,141178,131222,6757395,152037,85.4,96.1,63.4,91.3,93
8,10900,"Allentown-Bethlehem-Easton, PA-NJ (Metropolitan Statistical Area)",2019,55675,213800,1744,215544,212056,46992336,844052,98.6,99.1,96.9,99.1,107.4
9,11020,"Altoona, PA (Metropolitan Statistical Area)",2019,48277,123600,2755,126355,120845,5881562,121829,90.1,98.9,64.5,97.9,98.1
10,11100,"Amarillo, TX (Metropolitan Statistical Area)",2019,48065,140500,2458,142958,138042,12739902,265053,91.3,96.3,82.8,91.3,99.4
11,11180,"Ames, IA (Metropolitan Statistical Area)",2019,44952,170600,3777,174377,166823,5544823,123351,91.8,93.9,89.3,91.1,99.9
12,11260,"Anchorage, AK (Metropolitan Statistical Area)",2019,64350,294800,2760,297560,292040,25503163,396317,106.6,101.5,127.8,101,116
13,11460,"Ann Arbor, MI (Metropolitan Statistical Area)",2019,60843,263600,3237,266837,260363,22365853,367601,100.6,97.7,115.4,95.7,109.5
14,11500,"Anniston-Oxford, AL (Metropolitan Statistical Area)",2019,38394,118000,2973,120973,115027,4361788,113605,82.4,96.8,51,90.5,89.7
15,11540,"Appleton, WI (Metropolitan Statistical Area)",2019,52686,171300,1795,173095,169505,12537901,237974,88.9,95.4,73.1,91.4,96.8
16,11700,"Asheville, NC (Metropolitan Statistical Area)",2019,47432,220600,2776,223376,217824,21945716,462680,93.5,95.3,88,95.1,101.8
17,12020,"Athens-Clarke County, GA (Metropolitan Statistical Area)",2019,41495,178700,5067,183767,173633,8869497,213750,91,96.4,76.8,95.1,99.1
18,12060,"Atlanta-Sandy Springs-Alpharetta, GA (Metropolitan Statistical Area)",2019,54557,217000,954,217954,216046,328450133,6020364,97.9,98.2,97.2,98.1,106.6
19,12100,"Atlantic City-Hammonton, NJ (Metropolitan Statistical Area)",2019,50631,217900,3084,220984,214816,13349834,263670,98.6,100.5,93.1,100.3,107.4
20,12220,"Auburn-Opelika, AL (Metropolitan Statistical Area)",2019,39781,169300,4213,173513,165087,6545660,164542,85.1,92.7,68.1,90.1,92.7
21,12260,"Augusta-Richmond County, GA-SC (Metropolitan Statistical Area)",2019,43638,146100,2279,148379,143821,26574937,608980,89.3,96.2,70.4,95.1,97.2
22,12420,"Austin-Round Rock-Georgetown, TX (Metropolitan Statistical Area)",2019,61977,281500,1613,283113,279887,138028065,2227083,99.3,96.5,120.9,91.3,108.2
23,12540,"Bakersfield, CA (Metropolitan Statistical Area)",2019,41843,213900,2364,216264,211536,37666752,900202,97,98.2,88.4,102.2,105.7
24,12580,"Baltimore-Columbia-Towson, MD (Metropolitan Statistical Area)",2019,63988,298500,1190,299690,297310,179169101,2800053,105.8,101.7,113.7,103.8,115.2
25,12620,"Bangor, ME (Metropolitan Statistical Area)",2019,43136,144700,2594,147294,142106,6563124,152148,97.3,99.1,86.6,103.8,105.9
26,12700,"Barnstable Town, MA (Metropolitan Statistical Area)",2019,77435,393500,3335,396835,390165,16492955,212990,106.3,99.1,123.3,103.8,115.7
27,12940,"Baton Rouge, LA (Metropolitan Statistical Area)",2019,49439,181700,2162,183862,179538,42264278,854884,90.5,95.6,81.3,91.2,98.5
28,12980,"Battle Creek, MI (Metropolitan Statistical Area)",2019,40257,110000,2124,112124,107876,5400823,134159,87,95.4,68.8,91.4,94.7
29,13020,"Bay City, MI (Metropolitan Statistical Area)",2019,43657,102000,2781,104781,99219,4502212,103126,85.9,95.4,63.5,91.4,93.5
30,13140,"Beaumont-Port Arthur, TX (Metropolitan Statistical Area)",2019,45219,114500,2073,116573,112427,17751250,392563,87.3,96.5,67.5,91.3,95.1
31,13220,"Beckley, WV (Metropolitan Statistical Area)",2019,41128,101800,4150,105950,97650,4761221,115767,77.8,92.4,44,95,84.7
32,13380,"Bellingham, WA (Metropolitan Statistical Area)",2019,50915,345700,5347,351047,340353,11672154,229247,101.6,98.2,107.1,102.2,110.6
33,13460,"Bend, OR (Metropolitan Statistical Area)",2019,56447,364600,6118,370718,358482,11159204,197692,102.5,102.8,109,97.7,111.6
34,13740,"Billings, MT (Metropolitan Statistical Area)",2019,53960,227900,2196,230096,225704,9802775,181667,94.4,93.6,89.9,98.4,102.8
35,13780,"Binghamton, NY (Metropolitan Statistical Area)",2019,46484,117600,1519,119119,116081,11095201,238691,95,98.9,83.6,97.9,103.4
36,13820,"Birmingham-Hoover, AL (Metropolitan Statistical Area)",2019,53374,165200,1218,166418,163982,58200404,1090435,88.3,96.7,69.4,90.5,96.1
37,13900,"Bismarck, ND (Metropolitan Statistical Area)",2019,58254,249000,3897,252897,245103,7511736,128949,91.9,94.7,85.7,92.2,100.1
38,13980,"Blacksburg-Christiansburg, VA (Metropolitan Statistical Area) *",2019,39517,182600,5323,187923,177277,6620300,167531,90.2,92.5,80.1,95,98.2
39,14010,"Bloomington, IL (Metropolitan Statistical Area)",2019,49602,167000,1910,168910,165090,8507653,171517,91.6,95.4,84.9,91.4,99.7
40,14020,"Bloomington, IN (Metropolitan Statistical Area)",2019,43411,166400,3298,169698,163102,7346430,169230,91.5,95.3,86.4,91.3,99.7
41,14100,"Bloomsburg-Berwick, PA (Metropolitan Statistical Area)",2019,47097,158300,2621,160921,155679,3918174,83194,92.5,98.9,72.7,97.9,100.7
42,14260,"Boise City, ID (Metropolitan Statistical Area)",2019,47881,239900,2592,242492,237308,35872855,749202,93.6,93.2,87.2,99,102
43,14460,"Boston-Cambridge-Newton, MA-NH (Metropolitan Statistical Area)",2019,81498,437500,1325,438825,436175,397139161,4873019,115.5,103.7,143.6,111.3,125.8
44,14500,"Boulder, CO (Metropolitan Statistical Area) *",2019,76527,497300,6119,503419,491181,24962717,326196,106.7,96.4,152,96.6,116.1
45,14540,"Bowling Green, KY (Metropolitan Statistical Area)",2019,37114,151000,3932,154932,147068,6652350,179240,84.7,92.5,62.9,90.3,92.2
46,14740,"Bremerton-Silverdale-Port Orchard, WA (Metropolitan Statistical Area)",2019,58874,329900,4477,334377,325423,15982626,271473,108.7,106.6,119.9,104.6,118.4
47,14860,"Bridgeport-Stamford-Norwalk, CT (Metropolitan Statistical Area)",2019,121397,428500,3954,432454,424546,114517862,943332,112.4,105.3,134.4,109,122.4
48,15180,"Brownsville-Harlingen, TX (Metropolitan Statistical Area)",2019,29928,85800,1364,87164,84436,12664258,423163,82.2,96.5,56.9,91.3,89.5
49,15260,"Brunswick, GA (Metropolitan Statistical Area)",2019,42885,155300,5746,161046,149554,5093781,118779,87.8,92.5,71.6,95,95.6
50,15380,"Buffalo-Cheektowaga, NY (Metropolitan Statistical Area)",2019,52331,148500,941,149441,147559,59028041,1127983,94.5,98.9,79.9,97.9,102.9
51,15500,"Burlington, NC (Metropolitan Statistical Area)",2019,41193,154800,2576,157376,152224,6982583,169509,89.5,96.6,70.2,95.1,97.5
52,15540,"Burlington-South Burlington, VT (Metropolitan Statistical Area)",2019,58662,275600,3275,278875,272325,12929749,220411,106.2,99.1,122.8,103.8,115.6
53,15680,"California-Lexington Park, MD (Metropolitan Statistical Area)",2019,58582,301300,7297,308597,294003,6649699,113510,96.4,92.5,105.7,95,104.9
54,15940,"Canton-Massillon, OH (Metropolitan Statistical Area)",2019,46061,133900,1342,135242,132558,18310362,397520,85.2,95.4,60.6,91.4,92.8
55,15980,"Cape Coral-Fort Myers, FL (Metropolitan Statistical Area)",2019,52064,224800,2131,226931,222669,40119053,770577,97.7,96.6,104,95.1,106.3
56,16020,"Cape Girardeau, MO-IL (Metropolitan Statistical Area)",2019,44571,150800,3468,154268,147332,4312900,96765,84.7,93.9,64.6,91.1,92.2
57,16060,"Carbondale-Marion, IL (Metropolitan Statistical Area)",2019,41733,111800,3005,114805,108795,5665870,135764,83.2,94.6,59.8,90.4,90.6
58,16180,"Carson City, NV (Metropolitan Statistical Area)",2019,52470,273800,7926,281726,265874,2933904,55916,96.8,97.7,99.5,93.9,105.4
59,16220,"Casper, WY (Metropolitan Statistical Area)",2019,72187,208700,5138,213838,203562,5764702,79858,93,93,84.8,99.2,101.3
60,16300,"Cedar Rapids, IA (Metropolitan Statistical Area)",2019,53143,155800,1837,157637,153963,14509845,273032,88.4,94.6,71.1,92.1,96.3
61,16540,"Chambersburg-Waynesboro, PA (Metropolitan Statistical Area)",2019,47934,180400,2818,183218,177582,7431056,155027,94.3,98.9,79.4,97.9,102.7
62,16580,"Champaign-Urbana, IL (Metropolitan Statistical Area)",2019,46616,159700,2521,162221,157179,10536670,226033,91,95.3,83.7,91.3,99.1
63,16620,"Charleston, WV (Metropolitan Statistical Area)",2019,45276,107600,2521,110121,105079,11639393,257074,86,95.2,57.2,95.2,93.6
64,16700,"Charleston-North Charleston, SC (Metropolitan Statistical Area)",2019,53119,236700,2429,239129,234271,42607758,802122,97.1,96.6,101.4,95.1,105.7
65,16740,"Charlotte-Concord-Gastonia, NC-SC (Metropolitan Statistical Area)",2019,53916,200000,1446,201446,198554,142170385,2636883,94.4,96.2,89.5,95.1,102.8
66,16820,"Charlottesville, VA (Metropolitan Statistical Area) *",2019,69003,291100,4494,295594,286606,15084997,218615,98.8,96.4,112.8,95.1,107.6
67,16860,"Chattanooga, TN-GA (Metropolitan Statistical Area)",2019,47376,163100,1644,164744,161456,26776612,565194,89,96.6,73.3,90.5,96.9
68,16940,"Cheyenne, WY (Metropolitan Statistical Area)",2019,54113,227900,5083,232983,222817,5384262,99500,92.4,93,83.2,99.2,100.6
69,16980,"Chicago-Naperville-Elgin, IL-IN-WI (Metropolitan Statistical Area)",2019,63500,239600,635,240235,238965,600616821,9458539,102.8,100.2,112.4,100.1,111.9
70,17020,"Chico, CA (Metropolitan Statistical Area)",2019,47860,271700,5529,277229,266171,10490209,219186,100.6,98.2,102.6,102.2,109.5
71,17140,"Cincinnati, OH-KY-IN (Metropolitan Statistical Area)",2019,56033,168900,791,169691,168109,124461934,2221208,90.6,95.9,78.5,92.3,98.6
72,17300,"Clarksville, TN-KY (Metropolitan Statistical Area)",2019,41881,154600,2025,156625,152575,12891821,307820,88.2,96.5,73.2,90.5,96.1
73,17420,"Cleveland, TN (Metropolitan Statistical Area)",2019,39839,156300,3018,159318,153282,4977562,124942,85.5,92.7,67.1,90.2,93.1
74,17460,"Cleveland-Elyria, OH (Metropolitan Statistical Area)",2019,55451,151600,725,152325,150875,113588996,2048449,89.9,95.9,76.3,92.2,97.9
75,17660,"Coeur d'Alene, ID (Metropolitan Statistical Area)",2019,46645,260300,6078,266378,254222,7728980,165697,93.5,97.7,86.7,93.9,101.8
76,17780,"College Station-Bryan, TX (Metropolitan Statistical Area)",2019,41742,186800,4602,191402,182198,11050339,264728,91.2,96,84.7,91.2,99.4
77,17820,"Colorado Springs, CO (Metropolitan Statistical Area)",2019,51120,275700,1975,277675,273725,38125082,745791,99.3,93.2,111.4,99,108.1
78,17860,"Columbia, MO (Metropolitan Statistical Area)",2019,47482,175400,4255,179655,171145,9884411,208173,89.9,94.7,78,92.2,97.9
79,17900,"Columbia, SC (Metropolitan Statistical Area)",2019,46523,154400,1211,155611,153189,39006819,838433,91.4,96.2,77.6,95.1,99.5
80,17980,"Columbus, GA-AL (Metropolitan Statistical Area)",2019,42183,142800,3009,145809,139791,13542897,321048,88.6,96.2,69.3,95.1,96.5
81,18020,"Columbus, IN (Metropolitan Statistical Area)",2019,52546,153500,5053,158553,148447,4402236,83779,88.7,94.6,77.5,90.3,96.6
82,18140,"Columbus, OH (Metropolitan Statistical Area)",2019,52477,184800,1056,185856,183744,111370103,2122271,91.6,95.3,85,91.3,99.8
83,18580,"Corpus Christi, TX (Metropolitan Statistical Area)",2019,45140,135900,2212,138112,133688,19366168,429024,92.4,96.5,87.7,91.3,100.6
84,18700,"Corvallis, OR (Metropolitan Statistical Area)",2019,48725,331300,7332,338632,323968,4534024,93053,102.9,102.8,110.7,97.7,112
85,18880,"Crestview-Fort Walton Beach-Destin, FL (Metropolitan Statistical Area)",2019,54270,221300,3858,225158,217442,15456503,284809,94.5,94.5,93.5,95.2,102.9
86,19060,"Cumberland, MD-WV (Metropolitan Statistical Area)",2019,41195,127400,3986,131386,123414,4007649,97284,83.7,96.6,54.6,95.1,91.2
87,19100,"Dallas-Fort Worth-Arlington, TX (Metropolitan Statistical Area)",2019,58725,215700,779,216479,214921,444730277,7573136,101.2,98.9,109.9,98.6,110.1
88,19140,"Dalton, GA (Metropolitan Statistical Area)",2019,37444,127100,3569,130669,123531,5418976,144724,85.7,92.4,62.9,95,93.4
89,19180,"Danville, IL (Metropolitan Statistical Area)",2019,40109,79900,2168,82068,77732,3038613,75758,79.1,94.6,51,90.3,86.1
90,19300,"Daphne-Fairhope-Foley, AL (Metropolitan Statistical Area)",2019,47485,197900,4048,201948,193852,10600260,223234,90.2,96.8,81.7,90.5,98.3
91,19340,"Davenport-Moline-Rock Island, IA-IL (Metropolitan Statistical Area)",2019,50502,136200,1541,137741,134659,19149116,379172,88.3,94.7,71.7,92.2,96.1
92,19430,"Dayton-Kettering, OH (Metropolitan Statistical Area)",2019,49161,135000,1357,136357,133643,39703066,807611,87.6,95.4,69.6,91.4,95.4
93,19460,"Decatur, AL (Metropolitan Statistical Area)",2019,40295,131000,3948,134948,127052,6149159,152603,83.7,96.8,53.5,90.5,91.1
94,19500,"Decatur, IL (Metropolitan Statistical Area)",2019,48764,98400,2038,100438,96362,5071870,104009,85,95.4,60.3,91.4,92.5
95,19660,"Deltona-Daytona Beach-Ormond Beach, FL (Metropolitan Statistical Area)",2019,44762,184200,1615,185815,182585,29917225,668365,95.8,96.5,95.6,95.1,104.3
96,19740,"Denver-Aurora-Lakewood, CO (Metropolitan Statistical Area) *",2019,67236,380900,1318,382218,379582,199503851,2967239,104.2,97.7,139,95.9,113.4
97,19780,"Des Moines-West Des Moines, IA (Metropolitan Statistical Area)",2019,55039,182400,1912,184312,180488,38488124,699292,92.3,94.6,87.7,92.1,100.5
98,19820,"Detroit-Warren-Dearborn, MI (Metropolitan Statistical Area)",2019,54172,170000,592,170592,169408,234001030,4319629,95.3,97.8,86.1,97.7,103.8
99,20020,"Dothan, AL (Metropolitan Statistical Area)",2019,43143,127500,3164,130664,124336,6443785,149358,83.6,96,55.5,90.5,91
100,20100,"Dover, DE (Metropolitan Statistical Area)",2019,43097,220600,3934,224534,216666,7791288,180786,92.5,96.6,82.4,95.1,100.7
101,20220,"Dubuque, IA (Metropolitan Statistical Area)",2019,51525,166800,2785,169585,164015,5013959,97311,89.1,94.7,74.3,92.2,97
102,20260,"Duluth, MN-WI (Metropolitan Statistical Area)",2019,47654,158900,1496,160396,157404,13759223,288732,89.5,94.6,77.5,92.1,97.5
103,20500,"Durham-Chapel Hill, NC (Metropolitan Statistical Area)",2019,54423,226100,2540,228640,223560,35068510,644367,94.8,95.8,91.7,95.2,103.2
104,20700,"East Stroudsburg, PA (Metropolitan Statistical Area)",2019,43823,168000,2125,170125,165875,7461802,170271,98.4,98.9,98.3,97.9,107.1
105,20740,"Eau Claire, WI (Metropolitan Statistical Area)",2019,48956,168600,1878,170478,166722,8288411,169304,89,95.4,74.9,91.4,97
106,20940,"El Centro, CA (Metropolitan Statistical Area)",2019,40447,195800,6460,202260,189340,7329602,181215,90.4,102.8,67.3,97.7,98.4
107,21060,"Elizabethtown-Fort Knox, KY (Metropolitan Statistical Area)",2019,43076,152700,3058,155758,149642,6630660,153928,86.5,92.7,71.9,90.1,94.2
108,21140,"Elkhart-Goshen, IN (Metropolitan Statistical Area)",2019,46975,144300,2657,146957,141643,9692815,206341,88.8,95.4,73.2,91.4,96.7
109,21300,"Elmira, NY (Metropolitan Statistical Area)",2019,46421,105800,2993,108793,102807,3874102,83456,94.9,98.9,83,97.9,103.4
110,21340,"El Paso, TX (Metropolitan Statistical Area)",2019,37633,121300,935,122235,120365,31766708,844124,87.7,96.4,73.3,91.3,95.5
111,21420,"Enid, OK (Metropolitan Statistical Area)",2019,44899,112600,5239,117839,107361,2741380,61056,88.3,96.5,71.6,91.3,96.1
112,21500,"Erie, PA (Metropolitan Statistical Area)",2019,46379,134100,2049,136149,132051,12509662,269728,91.3,98.9,69.5,97.9,99.4
113,21660,"Eugene-Springfield, OR (Metropolitan Statistical Area)",2019,47340,263200,2968,266168,260232,18087217,382067,99.4,98.2,97.9,102.2,108.3
114,21780,"Evansville, IN-KY (Metropolitan Statistical Area)",2019,48896,139400,1842,141242,137558,15406351,315086,87.5,95.4,68,91.4,95.3
115,21820,"Fairbanks, AK (Metropolitan Statistical Area) *",2019,59958,240000,6430,246430,233570,5806852,96849,106.8,101.1,137.2,97.9,116.3
116,22020,"Fargo, ND-MN (Metropolitan Statistical Area)",2019,54932,215200,3646,218846,211554,13521155,246145,90.6,94.7,80.9,92.2,98.6
117,22140,"Farmington, NM (Metropolitan Statistical Area)",2019,35999,151200,4094,155294,147106,4462308,123958,90.3,97.7,73.5,93.9,98.3
118,22180,"Fayetteville, NC (Metropolitan Statistical Area)",2019,38204,141000,1919,142919,139081,20122626,526719,89,95.4,73.3,95.2,96.9
119,22220,"Fayetteville-Springdale-Rogers, AR (Metropolitan Statistical Area)",2019,67771,176000,3067,179067,172933,36251158,534904,88.2,96.4,70.1,91.3,96
120,22380,"Flagstaff, AZ (Metropolitan Statistical Area)",2019,49189,280900,7748,288648,273152,7057376,143476,99.3,97.7,110.8,93.9,108.2
121,22420,"Flint, MI (Metropolitan Statistical Area)",2019,41929,111100,1545,112645,109555,17015416,405813,88.7,97.7,65.9,95.7,96.6
122,22500,"Florence, SC (Metropolitan Statistical Area)",2019,42439,118600,3039,121639,115561,8696180,204911,87.5,95.6,62.6,95.1,95.3
123,22520,"Florence-Muscle Shoals, AL (Metropolitan Statistical Area)",2019,39102,135300,3333,138633,131967,5785895,147970,80.7,96.8,45.9,90.5,87.9
124,22540,"Fond du Lac, WI (Metropolitan Statistical Area)",2019,49949,157800,2116,159916,155684,5164866,103403,87.8,94.6,73,90.3,95.6
125,22660,"Fort Collins, CO (Metropolitan Statistical Area)",2019,55884,363800,3285,367085,360515,19944871,356899,102,93,125.7,99.2,111
126,22900,"Fort Smith, AR-OK (Metropolitan Statistical Area)",2019,38382,115000,2457,117457,112543,9609548,250368,82.9,96.3,55.2,91.2,90.3
127,23060,"Fort Wayne, IN (Metropolitan Statistical Area)",2019,47516,130700,1492,132192,129208,19636577,413263,88.1,95.4,70.4,91.4,95.9
128,23420,"Fresno, CA (Metropolitan Statistical Area)",2019,45487,255000,2340,257340,252660,45445944,999101,97.5,98.2,89.9,102.2,106.1
129,23460,"Gadsden, AL (Metropolitan Statistical Area)",2019,38326,113700,5290,118990,108410,3919481,102268,82.2,96.8,50,90.5,89.5
130,23540,"Gainesville, FL (Metropolitan Statistical Area)",2019,44880,167500,2970,170470,164530,14771206,329128,94.4,95.5,91.3,95.2,102.8
131,23580,"Gainesville, GA (Metropolitan Statistical Area)",2019,45576,201300,5669,206969,195631,9317545,204441,91.2,92.5,83.1,95,99.3
132,23900,"Gettysburg, PA (Metropolitan Statistical Area)",2019,50182,205800,3823,209623,201977,5169186,103009,95.6,98.9,85.5,97.9,104.1
133,24020,"Glens Falls, NY (Metropolitan Statistical Area)",2019,48823,172400,3128,175528,169272,6110108,125148,96.5,98.9,89.7,97.9,105.1
134,24140,"Goldsboro, NC (Metropolitan Statistical Area)",2019,39894,123500,4623,128123,118877,4912230,123131,87.1,96.6,62.6,95.1,94.8
135,24220,"Grand Forks, ND-MN (Metropolitan Statistical Area)",2019,51950,192100,3709,195809,188391,5237350,100815,89.4,94.7,77.2,92.2,97.3
136,24260,"Grand Island, NE (Metropolitan Statistical Area)",2019,45487,143200,3878,147078,139322,3436663,75553,85.5,93.9,64.3,91.1,93.1
137,24300,"Grand Junction, CO (Metropolitan Statistical Area)",2019,46719,227000,4298,231298,222702,7204611,154210,93.7,97.7,87.6,93.9,102
138,24340,"Grand Rapids-Kentwood, MI (Metropolitan Statistical Area)",2019,50330,172900,1027,173927,171873,54223857,1077370,92,95.3,87,91.3,100.2
139,24420,"Grants Pass, OR (Metropolitan Statistical Area)",2019,43554,265500,6670,272170,258830,3810451,87487,95.5,102.8,82.7,97.7,104
140,24500,"Great Falls, MT (Metropolitan Statistical Area)",2019,49803,179900,3665,183565,176235,4052262,81366,91.9,93,80.5,99.2,100.1
141,24540,"Greeley, CO (Metropolitan Statistical Area) *",2019,50198,299000,3597,302597,295403,16288858,324492,98,96.4,103,96.6,106.7
142,24580,"Green Bay, WI (Metropolitan Statistical Area)",2019,52981,171200,1363,172563,169837,17107901,322906,89.7,95.3,76.9,91.2,97.7
143,24660,"Greensboro-High Point, NC (Metropolitan Statistical Area)",2019,44859,149200,1543,150743,147657,34624284,771851,90,96.2,71.3,95.1,98
144,24780,"Greenville, NC (Metropolitan Statistical Area)",2019,43325,148600,4413,153013,144187,7830577,180742,87.4,96.6,65.7,95.1,95.2
145,24860,"Greenville-Anderson, SC (Metropolitan Statistical Area)",2019,45436,163400,1312,164712,162088,41822381,920477,90.7,96.4,74.1,95.1,98.7
146,25060,"Gulfport-Biloxi, MS (Metropolitan Statistical Area)",2019,37792,142500,2437,144937,140063,15784326,417665,87.2,96.6,69.6,90.5,95
147,25180,"Hagerstown-Martinsburg, MD-WV (Metropolitan Statistical Area)",2019,45281,195300,3216,198516,192084,13045602,288104,96.2,99,79.7,105,104.7
148,25220,"Hammond, LA (Metropolitan Statistical Area)",2019,38800,162800,4513,167313,158287,5228657,134758,86.3,92.3,72.2,90.9,94
149,25260,"Hanford-Corcoran, CA (Metropolitan Statistical Area)",2019,39433,215900,4963,220863,210937,6030809,152940,95.2,102.8,80.8,97.7,103.6
150,25420,"Harrisburg-Carlisle, PA (Metropolitan Statistical Area)",2019,53871,183400,1589,184989,181811,31134512,577941,95.9,98.9,86.5,97.9,104.4
151,25500,"Harrisonburg, VA (Metropolitan Statistical Area) *",2019,41312,209300,4762,214062,204538,5575624,134964,91.9,92.5,86.2,95,100
152,25540,"Hartford-East Hartford-Middletown, CT (Metropolitan Statistical Area)",2019,65132,249200,1406,250606,247794,78476365,1204877,102.5,99.2,106,103.9,111.6
153,25620,"Hattiesburg, MS (Metropolitan Statistical Area)",2019,39018,137100,5735,142835,131365,6588139,168849,84.7,92.5,65.1,90.3,92.2
154,25860,"Hickory-Lenoir-Morganton, NC (Metropolitan Statistical Area)",2019,40826,131600,2192,133792,129408,15093644,369711,87.4,96.6,61,95.1,95.1
155,25940,"Hilton Head Island-Bluffton, SC (Metropolitan Statistical Area)",2019,55551,285400,5724,291124,279676,12343180,222195,95.2,92.5,100,95,103.6
156,25980,"Hinesville, GA (Metropolitan Statistical Area)",2019,34962,124100,4177,128277,119923,2831749,80994,91.6,92.5,86.6,95.1,99.7
157,26140,"Homosassa Springs, FL (Metropolitan Statistical Area)",2019,39055,131500,3996,135496,127504,5844856,149657,89.1,92.5,77.8,95,97
158,26300,"Hot Springs, AR (Metropolitan Statistical Area)",2019,41069,139900,6110,146010,133790,4081660,99386,85,92.3,68.8,90.9,92.6
159,26380,"Houma-Thibodaux, LA (Metropolitan Statistical Area)",2019,43927,155100,2745,157845,152355,9140203,208075,88.1,96.5,71.4,91.3,95.9
160,26420,"Houston-The Woodlands-Sugar Land, TX (Metropolitan Statistical Area)",2019,58890,193900,821,194721,193079,416121512,7066141,101.7,95.6,104.7,106.8,110.8
161,26580,"Huntington-Ashland, WV-KY-OH (Metropolitan Statistical Area)",2019,41368,120600,2635,123235,117965,14721817,355873,85.6,96,56.5,94.9,93.2
162,26620,"Huntsville, AL (Metropolitan Statistical Area)",2019,52110,179700,2551,182251,177149,24586808,471824,89,96.8,70.6,90.5,96.9
163,26820,"Idaho Falls, ID (Metropolitan Statistical Area)",2019,47443,183000,4217,187217,178783,7189022,151530,91,97.7,76.2,93.8,99.1
164,26900,"Indianapolis-Carmel-Anderson, IN (Metropolitan Statistical Area)",2019,56360,163100,904,164004,162196,116920707,2074537,91.1,95.3,83.2,91.3,99.2
165,26980,"Iowa City, IA (Metropolitan Statistical Area)",2019,55834,216000,4178,220178,211822,9665204,173105,92.9,94.6,91,92.1,101.1
166,27060,"Ithaca, NY (Metropolitan Statistical Area)",2019,46496,204600,6041,210641,198559,4750972,102180,105.3,98.9,134.9,97.9,114.7
167,27100,"Jackson, MI (Metropolitan Statistical Area)",2019,40387,131600,2862,134462,128738,6401733,158510,87.6,95.4,69.3,91.4,95.3
168,27140,"Jackson, MS (Metropolitan Statistical Area)",2019,44734,145600,1925,147525,143675,26608102,594806,87.7,96.3,69.2,90.5,95.5
169,27180,"Jackson, TN (Metropolitan Statistical Area)",2019,41794,118000,2740,120740,115260,7466160,178644,80.7,92.5,53.3,90.3,87.8
170,27260,"Jacksonville, FL (Metropolitan Statistical Area)",2019,51421,204700,2179,206879,202521,80191700,1559514,95.4,96.5,94,95.1,103.9
171,27340,"Jacksonville, NC (Metropolitan Statistical Area)",2019,47525,156900,3206,160106,153694,9407046,197938,91.6,96.5,81.3,95.1,99.8
172,27500,"Janesville-Beloit, WI (Metropolitan Statistical Area)",2019,46236,146200,2297,148497,143903,7552841,163354,89.6,95.4,76.8,91.4,97.5
173,27620,"Jefferson City, MO (Metropolitan Statistical Area)",2019,44141,157000,3127,160127,153873,6675625,151235,83.2,93.9,56.5,91.1,90.6
174,27740,"Johnson City, TN (Metropolitan Statistical Area)",2019,41209,148400,3189,151589,145211,8392139,203649,85.3,96.8,60.4,90.5,92.9
175,27780,"Johnstown, PA (Metropolitan Statistical Area)",2019,45107,91900,2063,93963,89837,5872588,130192,85.1,98.9,48.8,97.9,92.7
176,27860,"Jonesboro, AR (Metropolitan Statistical Area)",2019,38122,127500,3724,131224,123776,5103025,133860,83.7,92.3,63.9,90.9,91.2
177,27900,"Joplin, MO (Metropolitan Statistical Area)",2019,41423,122200,2980,125180,119220,7438057,179564,83.6,94.7,55.9,92.2,91
178,27980,"Kahului-Wailuku-Lahaina, HI (Metropolitan Statistical Area)",2019,51348,633500,11626,645126,621874,8600887,167503,113.3,105.7,144.3,100.1,123.3
179,28020,"Kalamazoo-Portage, MI (Metropolitan Statistical Area)",2019,49493,159300,2078,161378,157222,13118941,265066,89.8,95.4,78.3,91.4,97.8
180,28100,"Kankakee, IL (Metropolitan Statistical Area)",2019,42687,147900,3195,151095,144705,4689720,109862,92.9,97.2,78.2,98.8,101.2
181,28140,"Kansas City, MO-KS (Metropolitan Statistical Area)",2019,55009,183300,1023,184323,182277,118708230,2157990,92.8,95.5,83.1,95.6,101
182,28420,"Kennewick-Richland, WA (Metropolitan Statistical Area)",2019,46231,226700,3691,230391,223009,13851313,299612,98.6,98.2,94,102.2,107.4
183,28660,"Killeen-Temple, TX (Metropolitan Statistical Area)",2019,42855,143700,2402,146102,141298,19726228,460303,89.1,96.3,76.7,91.3,97
184,28700,"Kingsport-Bristol, TN-VA (Metropolitan Statistical Area) *",2019,40918,134400,2100,136500,132300,12570113,307202,84.5,96.7,56.1,91.5,92
185,28740,"Kingston, NY (Metropolitan Statistical Area)",2019,53006,230500,3803,234303,226697,9412460,177573,102.6,98.9,119.9,97.9,111.8
186,28940,"Knoxville, TN (Metropolitan Statistical Area)",2019,47550,171300,1333,172633,169967,41323565,869046,88.4,96.3,70.9,90.5,96.3
187,29020,"Kokomo, IN (Metropolitan Statistical Area)",2019,42911,109500,3143,112643,106357,3542015,82544,85.4,95.4,61.8,91.4,93
188,29100,"La Crosse-Onalaska, WI-MN (Metropolitan Statistical Area)",2019,52035,173400,2015,175415,171385,7108822,136616,90.8,95.4,82.3,91.4,98.9
189,29180,"Lafayette, LA (Metropolitan Statistical Area)",2019,44512,157100,2103,159203,154997,21775660,489207,85.6,95.7,64.3,91.2,93.2
190,29200,"Lafayette-West Lafayette, IN (Metropolitan Statistical Area)",2019,40164,145800,2970,148770,142830,9358207,233002,89.8,95.2,78.9,91.2,97.8
191,29340,"Lake Charles, LA (Metropolitan Statistical Area)",2019,49642,155600,3544,159144,152056,10445141,210409,88.6,96.4,73,91.3,96.5
192,29420,"Lake Havasu City-Kingman, AZ (Metropolitan Statistical Area)",2019,34393,160500,3370,163870,157130,7297603,212181,89.3,93,73.2,99.2,97.2
193,29460,"Lakeland-Winter Haven, FL (Metropolitan Statistical Area)",2019,36649,150800,2046,152846,148754,26562710,724777,93.5,96.6,86.1,95.1,101.8
194,29540,"Lancaster, PA (Metropolitan Statistical Area)",2019,54314,209400,1913,211313,207487,29640682,545724,98.1,98.9,96.7,97.9,106.8
195,29620,"Lansing-East Lansing, MI (Metropolitan Statistical Area)",2019,42495,146700,1397,148097,145303,23389059,550391,90.4,95.3,80.4,91.3,98.4
196,29700,"Laredo, TX (Metropolitan Statistical Area)",2019,32466,125900,2849,128749,123051,8981800,276652,86.1,96.5,67.3,91.3,93.7
197,29740,"Las Cruces, NM (Metropolitan Statistical Area)",2019,37756,147400,3610,151010,143790,8238087,218195,85.7,93,63.8,99.2,93.3
198,29820,"Las Vegas-Henderson-Paradise, NV (Metropolitan Statistical Area)",2019,48806,262700,1426,264126,261274,110628465,2266715,96.9,93,100.5,99.2,105.5
199,29940,"Lawrence, KS (Metropolitan Statistical Area)",2019,45163,199400,4931,204331,194469,5521639,122259,91.1,94.7,83.4,92.2,99.2
200,30020,"Lawton, OK (Metropolitan Statistical Area)",2019,42692,121700,3375,125075,118325,5396858,126415,87.6,96,70.7,91.3,95.3
201,30140,"Lebanon, PA (Metropolitan Statistical Area)",2019,48924,171300,2385,173685,168915,6937119,141793,95.7,98.9,85.8,97.9,104.2
202,30300,"Lewiston, ID-WA (Metropolitan Statistical Area)",2019,47650,193700,6459,200159,187241,3001480,62990,90.8,97.7,75.2,93.9,98.8
203,30340,"Lewiston-Auburn, ME (Metropolitan Statistical Area)",2019,42968,158200,2987,161187,155213,4652478,108277,96.1,99.1,81.5,103.8,104.6
204,30460,"Lexington-Fayette, KY (Metropolitan Statistical Area)",2019,49606,182700,2007,184707,180693,25648827,517056,90.6,96.8,78.6,90.5,98.6
205,30620,"Lima, OH (Metropolitan Statistical Area)",2019,43788,118100,2869,120969,115231,4481729,102351,84,95.4,57.6,91.4,91.5
206,30700,"Lincoln, NE (Metropolitan Statistical Area)",2019,50833,176600,2098,178698,174502,17098776,336374,90.9,94.6,81.7,92.2,98.9
207,30780,"Little Rock-North Little Rock-Conway, AR (Metropolitan Statistical Area)",2019,46560,154600,1406,156006,153194,34565252,742384,87.7,96.4,69.7,91.3,95.5
208,30860,"Logan, UT-ID (Metropolitan Statistical Area)",2019,41370,234100,3921,238021,230179,5881417,142165,90.9,97.7,76.7,93.9,99
209,30980,"Longview, TX (Metropolitan Statistical Area)",2019,42953,134000,3092,137092,130908,12312747,286657,89.1,95.9,75.2,91.2,97
210,31020,"Longview, WA (Metropolitan Statistical Area)",2019,46503,219300,5393,224693,213907,5142891,110593,96.4,102.8,84.7,97.7,105
211,31080,"Los Angeles-Long Beach-Anaheim, CA (Metropolitan Statistical Area)",2019,66684,613400,1254,614654,612146,881215471,13214799,118.8,105.7,169.5,106.9,129.3
212,31140,"Louisville/Jefferson County, KY-IN (Metropolitan Statistical Area)",2019,52134,169500,1117,170617,168383,65954660,1265108,89.6,96.6,74.9,90.5,97.6
213,31180,"Lubbock, TX (Metropolitan Statistical Area)",2019,44169,137300,2891,140191,134409,14233889,322257,91,96.2,82.5,91.3,99.1
214,31340,"Lynchburg, VA (Metropolitan Statistical Area) *",2019,41265,169100,2354,171454,166746,10875932,263566,90.2,96.4,72.2,95.1,98.3
215,31420,"Macon-Bibb County, GA (Metropolitan Statistical Area)",2019,42191,122200,3295,125495,118905,9703865,229996,87.4,95.9,63.2,95.1,95.2
216,31460,"Madera, CA (Metropolitan Statistical Area)",2019,41267,251200,6261,257461,244939,6492474,157327,94.7,98.2,80.6,102.2,103.2
217,31540,"Madison, WI (Metropolitan Statistical Area)",2019,62087,248400,1631,250031,246769,41279684,664865,96.4,95.3,108.9,91.2,104.9
218,31700,"Manchester-Nashua, NH (Metropolitan Statistical Area)",2019,63218,274800,1847,276647,272953,26363623,417025,107.6,101.1,118.6,107.8,117.1
219,31740,"Manhattan, KS (Metropolitan Statistical Area)",2019,47072,182300,4264,186564,178036,6132748,130285,90.5,93.9,85.3,91.1,98.6
220,31860,"Mankato, MN (Metropolitan Statistical Area)",2019,48219,187600,2430,190030,185170,4914860,101927,91.6,93.9,88.5,91.1,99.7
221,31900,"Mansfield, OH (Metropolitan Statistical Area)",2019,40507,110600,2659,113259,107941,4907564,121154,83.7,95.4,56.5,91.4,91.1
222,32580,"McAllen-Edinburg-Mission, TX (Metropolitan Statistical Area)",2019,27415,87100,997,88097,86103,23815443,868707,82.2,96.5,56.8,91.3,89.5
223,32780,"Medford, OR (Metropolitan Statistical Area)",2019,48291,280300,4790,285090,275510,10669698,220944,98.2,98.2,93.3,102.2,107
224,32820,"Memphis, TN-MS-AR (Metropolitan Statistical Area)",2019,47985,152200,1425,153625,150775,64590483,1346045,89.6,96.7,75.6,90.5,97.5
225,32900,"Merced, CA (Metropolitan Statistical Area)",2019,41077,252700,4581,257281,248119,11406396,277680,96.7,98.2,86.5,102.2,105.2
226,33100,"Miami-Fort Lauderdale-Pompano Beach, FL (Metropolitan Statistical Area)",2019,60966,280400,1069,281469,279331,375944348,6166488,111.7,103.5,132.5,105.8,121.6
227,33140,"Michigan City-La Porte, IN (Metropolitan Statistical Area)",2019,43910,132600,4115,136715,128485,4825145,109888,84.6,94.6,63.7,90.3,92.1
228,33220,"Midland, MI (Metropolitan Statistical Area)",2019,55972,141700,3071,144771,138629,4654376,83156,89.1,95.4,74.3,91.4,97
229,33260,"Midland, TX (Metropolitan Statistical Area)",2019,128766,211000,7287,218287,203713,23513106,182603,98.8,96.2,122.7,91.3,107.6
230,33340,"Milwaukee-Waukesha, WI (Metropolitan Statistical Area)",2019,58457,213900,1190,215090,212710,92079893,1575179,94.6,96.3,92.2,94.1,103
231,33460,"Minneapolis-St. Paul-Bloomington, MN-WI (Metropolitan Statistical Area)",2019,64255,257000,725,257725,256275,233890054,3640043,102.9,104.9,111.3,97.1,112
232,33540,"Missoula, MT (Metropolitan Statistical Area)",2019,51090,284000,5255,289255,278745,6110361,119600,95.4,97.7,93.5,93.9,103.8
233,33660,"Mobile, AL (Metropolitan Statistical Area)",2019,40025,128900,2295,131195,126605,17192338,429536,85.3,96.4,61.6,90.5,92.9
234,33700,"Modesto, CA (Metropolitan Statistical Area)",2019,45742,291600,2760,294360,288840,25188224,550660,101,98.2,104.8,102.2,110
235,33740,"Monroe, LA (Metropolitan Statistical Area)",2019,41825,127600,4671,132271,122929,8375896,200261,83.3,95.8,56.9,91.2,90.7
236,33780,"Monroe, MI (Metropolitan Statistical Area)",2019,48581,161700,2173,163873,159527,7311437,150500,90.4,97.7,72.2,95.7,98.4
237,33860,"Montgomery, AL (Metropolitan Statistical Area)",2019,44870,141600,2342,143942,139258,16749561,373290,87.8,96.7,69.1,90.5,95.6
238,34060,"Morgantown, WV (Metropolitan Statistical Area)",2019,44458,170600,4227,174827,166373,6181584,139044,89.8,92.5,77.8,95,97.8
239,34100,"Morristown, TN (Metropolitan Statistical Area)",2019,37452,137900,3341,141241,134559,5346273,142749,83.2,92.7,60.1,90.2,90.6
240,34580,"Mount Vernon-Anacortes, WA (Metropolitan Statistical Area)",2019,54505,306000,7322,313322,298678,7042338,129205,101.4,102.8,104.6,97.7,110.4
241,34620,"Muncie, IN (Metropolitan Statistical Area)",2019,38129,93600,2474,96074,91126,4351803,114135,85.7,95.4,65.4,91.4,93.3
242,34740,"Muskegon, MI (Metropolitan Statistical Area)",2019,39637,117900,1719,119619,116181,6879677,173566,86.7,95.4,67.1,91.4,94.4
243,34820,"Myrtle Beach-Conway-North Myrtle Beach, SC-NC (Metropolitan Statistical Area)",2019,40494,189100,2442,191542,186658,20121637,496901,92.2,95.5,85,95.2,100.4
244,34900,"Napa, CA (Metropolitan Statistical Area)",2019,75717,635900,8068,643968,627832,10429596,137744,120.8,109.3,166.1,110.5,131.5
245,34940,"Naples-Marco Island, FL (Metropolitan Statistical Area)",2019,99382,360800,5990,366790,354810,38252405,384902,100.9,96.6,123.9,95.1,109.9
246,34980,"Nashville-Davidson--Murfreesboro--Franklin, TN (Metropolitan Statistical Area)",2019,60680,240800,1402,242202,239398,117373879,1934317,94.4,96.6,97.7,90.5,102.8
247,35100,"New Bern, NC (Metropolitan Statistical Area)",2019,45788,152800,3314,156114,149486,5690657,124284,85.5,92.5,65.5,95,93.1
248,35300,"New Haven-Milford, CT (Metropolitan Statistical Area)",2019,57748,248600,2085,250685,246515,49360086,854757,106.2,103.9,107.1,107.9,115.6
249,35380,"New Orleans-Metairie, LA (Metropolitan Statistical Area)",2019,54363,197800,1537,199337,196263,69069320,1270530,93.1,96.3,90.6,91.3,101.4
250,35620,"New York-Newark-Jersey City, NY-NJ-PA (Metropolitan Statistical Area)",2019,79844,450900,823,451723,450077,1534294144,19216182,125.7,109.9,151.8,123.5,136.8
251,35660,"Niles, MI (Metropolitan Statistical Area)",2019,48237,150700,2565,153265,148135,7399551,153401,85.9,95.4,64.2,91.4,93.5
252,35840,"North Port-Sarasota-Bradenton, FL (Metropolitan Statistical Area)",2019,58081,246400,1835,248235,244565,48613206,836995,100.8,96.5,119.9,95.1,109.8
253,35980,"Norwich-New London, CT (Metropolitan Statistical Area)",2019,59717,241700,2904,244604,238796,15837267,265206,102.5,99.1,106.1,103.8,111.6
254,36100,"Ocala, FL (Metropolitan Statistical Area)",2019,38293,139900,3154,143054,136746,13999019,365579,91.7,96.6,79.3,95.1,99.8
255,36140,"Ocean City, NJ (Metropolitan Statistical Area)",2019,62734,300500,7192,307692,293308,5773945,92039,101.9,100.5,106.8,100.3,110.9
256,36220,"Odessa, TX (Metropolitan Statistical Area)",2019,50161,140500,5688,146188,134812,8337928,166223,95.1,96.5,99.7,91.3,103.6
257,36260,"Ogden-Clearfield, UT (Metropolitan Statistical Area)",2019,46123,255500,2443,257943,253057,31541823,683864,94.3,93.4,89.8,98.8,102.7
258,36420,"Oklahoma City, OK (Metropolitan Statistical Area)",2019,48860,157600,892,158492,156708,68841224,1408950,89.8,96.3,76.7,91.3,97.8
259,36500,"Olympia-Lacey-Tumwater, WA (Metropolitan Statistical Area)",2019,52828,287900,3595,291495,284305,15348436,290536,108.5,106.6,118.5,104.6,118.1
260,36540,"Omaha-Council Bluffs, NE-IA (Metropolitan Statistical Area)",2019,58947,171000,897,171897,170103,55966372,949442,91.7,94.6,85.2,92.2,99.9
261,36740,"Orlando-Kissimmee-Sanford, FL (Metropolitan Statistical Area)",2019,45156,221600,1481,223081,220119,117774061,2608147,99,96.5,109.5,95.1,107.8
262,36780,"Oshkosh-Neenah, WI (Metropolitan Statistical Area)",2019,49276,152500,2239,154739,150261,8470908,171907,89.1,95.4,74.1,91.4,97
263,36980,"Owensboro, KY (Metropolitan Statistical Area)",2019,41858,129400,3230,132630,126170,4999502,119440,87.6,96.4,65.7,90.5,95.4
264,37100,"Oxnard-Thousand Oaks-Ventura, CA (Metropolitan Statistical Area)",2019,64715,588400,3247,591647,585153,54749053,846006,117,101.1,174.6,106.9,127.4
265,37340,"Palm Bay-Melbourne-Titusville, FL (Metropolitan Statistical Area)",2019,47911,196400,2183,198583,194217,28839354,601942,96.7,96.5,99.6,95.1,105.3
266,37460,"Panama City, FL (Metropolitan Statistical Area)",2019,45690,178400,4713,183113,173687,7982208,174705,95.6,96.5,94.9,95.1,104.1
267,37620,"Parkersburg-Vienna, WV (Metropolitan Statistical Area)",2019,43967,122300,3303,125603,118997,3927966,89339,87.5,96.4,61.6,95.1,95.3
268,37860,"Pensacola-Ferry Pass-Brent, FL (Metropolitan Statistical Area)",2019,44947,164000,2147,166147,161853,22591862,502629,92.5,96.6,82.7,95.1,100.8
269,37900,"Peoria, IL (Metropolitan Statistical Area)",2019,49097,132000,1746,133746,130254,19666390,400561,87.3,95.3,67.5,91.3,95
270,37980,"Philadelphia-Camden-Wilmington, PA-NJ-DE-MD (Metropolitan Statistical Area)",2019,66596,250700,905,251605,249795,406399941,6102434,105.3,100.1,108.5,108.5,114.6
271,38060,"Phoenix-Mesa-Chandler, AZ (Metropolitan Statistical Area)",2019,48065,250000,982,250982,249018,237836502,4948203,98.7,94.2,102.7,101,107.4
272,38220,"Pine Bluff, AR (Metropolitan Statistical Area)",2019,35611,83300,2838,86138,80462,3126791,87804,80.8,95.8,49.1,91.2,88
273,38300,"Pittsburgh, PA (Metropolitan Statistical Area)",2019,60227,154000,744,154744,153256,139582271,2317600,92.4,98.9,78.9,92.4,100.6
274,38340,"Pittsfield, MA (Metropolitan Statistical Area)",2019,58299,216100,5956,222056,210144,7284151,124944,98.4,99.1,89.9,103.8,107.1
275,38540,"Pocatello, ID (Metropolitan Statistical Area)",2019,39573,159100,2813,161913,156287,3778833,95489,88.2,97.6,67.5,93.8,96
276,38860,"Portland-South Portland, ME (Metropolitan Statistical Area)",2019,60000,263300,2114,265414,261186,32310227,538500,103.7,99.3,110.9,104.1,112.9
277,38900,"Portland-Vancouver-Hillsboro, OR-WA (Metropolitan Statistical Area)",2019,59921,368800,1371,370171,367429,149346827,2492412,105,101.6,127.1,97.6,114.3
278,38940,"Port St. Lucie, FL (Metropolitan Statistical Area)",2019,55691,210100,3530,213630,206570,27249575,489297,97.1,96.5,101,95.1,105.7
279,39100,"Poughkeepsie-Newburgh-Middletown, NY (Metropolitan Statistical Area)",2019,55745,276500,1844,278344,274656,37859352,679158,118.6,110,128.5,119.3,129.2
280,39150,"Prescott Valley-Prescott, AZ (Metropolitan Statistical Area)",2019,41393,252000,5214,257214,246786,9731391,235099,94.8,97.7,91.6,93.9,103.2
281,39300,"Providence-Warwick, RI-MA (Metropolitan Statistical Area)",2019,56138,276900,1367,278267,275533,91200004,1624578,100.3,99.5,95.7,104.6,109.3
282,39340,"Provo-Orem, UT (Metropolitan Statistical Area)",2019,42923,303300,3529,306829,299771,27824776,648252,96.3,93.1,98.3,99.1,104.8
283,39380,"Pueblo, CO (Metropolitan Statistical Area)",2019,40680,164600,2443,167043,162157,6851552,168424,89.5,93,73.1,99.2,97.4
284,39460,"Punta Gorda, FL (Metropolitan Statistical Area)",2019,42793,195400,4224,199624,191176,8083940,188910,96.1,96.5,96.6,95.1,104.6
285,39540,"Racine, WI (Metropolitan Statistical Area)",2019,50845,176000,3251,179251,172749,9981409,196311,92,96.3,81,94.1,100.1
286,39580,"Raleigh-Cary, NC (Metropolitan Statistical Area)",2019,57851,249800,2320,252120,247480,80458462,1390785,96.1,96.6,97,95.1,104.6
287,39660,"Rapid City, SD (Metropolitan Statistical Area)",2019,51335,188400,3556,191956,184844,7295050,142107,89.2,94.6,76,92,97.1
288,39740,"Reading, PA (Metropolitan Statistical Area)",2019,51299,178700,2132,180832,176568,21605098,421164,95.6,98.9,85.4,97.9,104.1
289,39820,"Redding, CA (Metropolitan Statistical Area)",2019,48438,252300,4720,257020,247580,8722632,180080,98,98.2,92.5,102.2,106.7
290,39900,"Reno, NV (Metropolitan Statistical Area)",2019,63328,333000,3050,336050,329950,30121290,475642,98.4,93,108.1,99.1,107.1
291,40060,"Richmond, VA (Metropolitan Statistical Area) *",2019,58628,237500,1408,238908,236092,75741839,1291900,95.8,96.5,95.8,95.1,104.4
292,40140,"Riverside-San Bernardino-Ontario, CA (Metropolitan Statistical Area)",2019,42242,341300,1218,342518,340082,196452976,4650631,107.3,99.2,120.6,107.2,116.8
293,40220,"Roanoke, VA (Metropolitan Statistical Area) *",2019,48374,180100,2528,182628,177572,15151947,313222,91.2,96,77,95.1,99.3
294,40340,"Rochester, MN (Metropolitan Statistical Area)",2019,56050,201100,2808,203908,198292,12438700,221921,92.9,94.5,91.4,92,101.2
295,40380,"Rochester, NY (Metropolitan Statistical Area)",2019,53230,144400,867,145267,143533,56936973,1069644,97.1,98.9,92.3,97.9,105.8
296,40420,"Rockford, IL (Metropolitan Statistical Area)",2019,44783,124800,1588,126388,123212,15052234,336116,86.9,95.4,68.8,91.4,94.7
297,40580,"Rocky Mount, NC (Metropolitan Statistical Area)",2019,41444,111100,3084,114184,108016,6041241,145770,84.6,96.6,52.9,95.1,92.1
298,40660,"Rome, GA (Metropolitan Statistical Area)",2019,39314,132400,6102,138502,126298,3872375,98498,83.9,92.4,57.7,95,91.3
299,40900,"Sacramento-Roseville-Folsom, CA (Metropolitan Statistical Area)",2019,58843,387500,1610,389110,385890,139088819,2363730,105.2,98.2,126.1,102.2,114.6
300,40980,"Saginaw, MI (Metropolitan Statistical Area)",2019,40533,101300,2402,103702,98898,7723177,190539,85.7,95.4,63.2,91.4,93.3
301,41060,"St. Cloud, MN (Metropolitan Statistical Area)",2019,47436,182700,2057,184757,180643,9580328,201964,90.2,94.7,79.7,92.2,98.3
302,41100,"St. George, UT (Metropolitan Statistical Area)",2019,40886,283800,3742,287542,280058,7259617,177556,94.3,97.7,90,93.9,102.7
303,41140,"St. Joseph, MO-KS (Metropolitan Statistical Area)",2019,40135,123100,2607,125707,120493,5025839,125223,85.2,94.6,60.6,92.1,92.8
304,41180,"St. Louis, MO-IL (Metropolitan Statistical Area)",2019,56923,172700,751,173451,171949,159567017,2803228,90.1,95.6,80.6,89.6,98.1
305,41420,"Salem, OR (Metropolitan Statistical Area)",2019,44709,250800,3592,254392,247208,19399478,433903,99,101.6,96.4,97.6,107.7
306,41500,"Salinas, CA (Metropolitan Statistical Area)",2019,59838,516600,12283,528883,504317,25973189,434061,111.4,98.2,160.9,102.2,121.3
307,41540,"Salisbury, MD-DE (Metropolitan Statistical Area)",2019,49473,234800,3128,237928,231672,20567257,415726,90,92.5,79.5,95,98
308,41620,"Salt Lake City, UT (Metropolitan Statistical Area)",2019,54450,298600,1715,300315,296885,67119992,1232696,98.6,93.2,109.4,99,107.4
309,41660,"San Angelo, TX (Metropolitan Statistical Area)",2019,49308,140000,5054,145054,134946,6016858,122027,91.3,96.3,83.1,91.3,99.4
310,41700,"San Antonio-New Braunfels, TX (Metropolitan Statistical Area)",2019,48684,171000,1011,172011,169989,124191616,2550960,93.3,96.2,91.4,91.3,101.5
311,41740,"San Diego-Chula Vista-Carlsbad, CA (Metropolitan Statistical Area)",2019,63729,563700,2599,566299,561101,212748650,3338330,117.9,100.4,172,109.8,128.4
312,41860,"San Francisco-Oakland-Berkeley, CA (Metropolitan Statistical Area)",2019,104921,840600,3101,843701,837499,496466826,4731803,134.5,114.7,200.3,118.5,146.4
313,41940,"San Jose-Sunnyvale-Santa Clara, CA (Metropolitan Statistical Area)",2019,114080,968800,5412,974212,963388,227095402,1990660,126.7,109.1,224,110.3,137.9
314,42020,"San Luis Obispo-Paso Robles, CA (Metropolitan Statistical Area)",2019,61004,574000,7158,581158,566842,17270828,283111,110.2,98.2,152.4,102.2,120
315,42100,"Santa Cruz-Watsonville, CA (Metropolitan Statistical Area)",2019,71592,756600,11286,767886,745314,19559977,273213,122.7,109.3,174.5,110.5,133.6
316,42140,"Santa Fe, NM (Metropolitan Statistical Area)",2019,60276,291800,4739,296539,287061,9063004,150358,97,93,101.6,99.2,105.6
317,42200,"Santa Maria-Santa Barbara, CA (Metropolitan Statistical Area)",2019,66076,577400,12923,590323,564477,29502767,446499,112.1,98.2,169.1,102.2,122.1
318,42220,"Santa Rosa-Petaluma, CA (Metropolitan Statistical Area)",2019,66700,609600,5255,614855,604345,32972432,494336,120.6,109.3,162.2,110.5,131.3
319,42340,"Savannah, GA (Metropolitan Statistical Area)",2019,47869,188900,4279,193179,184621,18829571,393353,94.5,96.6,89.6,95.1,102.9
320,42540,"Scranton--Wilkes-Barre, PA (Metropolitan Statistical Area)",2019,47385,139400,1610,141010,137790,26245576,553885,91.5,98.9,69.9,97.9,99.6
321,42660,"Seattle-Tacoma-Bellevue, WA (Metropolitan Statistical Area)",2019,78073,436100,1921,438021,434179,310717787,3979845,114.5,108.1,148.4,104.7,124.7
322,42680,"Sebastian-Vero Beach, FL (Metropolitan Statistical Area)",2019,80818,202300,6803,209103,195497,12924659,159923,92.8,92.5,90.4,95,101.1
323,42700,"Sebring-Avon Park, FL (Metropolitan Statistical Area)",2019,34480,108100,4491,112591,103609,3662511,106221,87,92.5,70.5,95,94.7
324,43100,"Sheboygan, WI (Metropolitan Statistical Area)",2019,54703,159700,2412,162112,157288,6309435,115340,88.6,95.4,72.4,91.4,96.4
325,43300,"Sherman-Denison, TX (Metropolitan Statistical Area)",2019,43987,137400,5653,143053,131747,5991490,136212,91,96.5,81.4,91.3,99
326,43340,"Shreveport-Bossier City, LA (Metropolitan Statistical Area)",2019,48310,155400,2229,157629,153171,19068236,394706,87.2,96.3,69.7,91.3,95
327,43420,"Sierra Vista-Douglas, AZ (Metropolitan Statistical Area)",2019,41766,146800,4553,151353,142247,5259219,125922,88.3,97.7,70.7,93.9,96.2
328,43580,"Sioux City, IA-NE-SD (Metropolitan Statistical Area)",2019,52829,126200,3575,129775,122625,7644480,144701,88.3,94.6,70,92.1,96.2
329,43620,"Sioux Falls, SD (Metropolitan Statistical Area)",2019,62003,193300,2806,196106,190494,16631099,268232,91.2,94.6,83.2,92.2,99.3
330,43780,"South Bend-Mishawaka, IN-MI (Metropolitan Statistical Area)",2019,48035,131500,1942,133442,129558,15544754,323613,88.3,95.3,72.3,91.2,96.1
331,43900,"Spartanburg, SC (Metropolitan Statistical Area)",2019,44169,141400,2188,143588,139212,14124521,319785,89.5,96.6,68.8,95.1,97.4
332,44060,"Spokane-Spokane Valley, WA (Metropolitan Statistical Area)",2019,47827,222400,1735,224135,220665,27190815,568521,96.5,98.7,85.4,101.6,105
333,44100,"Springfield, IL (Metropolitan Statistical Area)",2019,49301,141500,1942,143442,139558,10198822,206868,89,95.4,72.4,91.4,96.9
334,44140,"Springfield, MA (Metropolitan Statistical Area)",2019,53978,228100,1249,229349,226851,37643308,697382,97.3,99.1,86.6,103.8,106
335,44180,"Springfield, MO (Metropolitan Statistical Area)",2019,42605,147700,1739,149439,145961,20037243,470300,85.9,94.6,65.2,92.1,93.5
336,44220,"Springfield, OH (Metropolitan Statistical Area)",2019,41811,115500,2098,117598,113402,5606209,134083,84.4,95.4,59.4,91.4,91.9
337,44300,"State College, PA (Metropolitan Statistical Area)",2019,47564,234900,4364,239264,230536,7723642,162385,100,98.9,105.9,97.9,108.9
338,44420,"Staunton, VA (Metropolitan Statistical Area) *",2019,45658,198600,4653,203253,193947,5621379,123120,88.2,92.5,73.5,95,96
339,44700,"Stockton, CA (Metropolitan Statistical Area)",2019,47139,342100,3031,345131,339069,35926949,762148,102.2,98.2,109.9,102.2,111.3
340,44940,"Sumter, SC (Metropolitan Statistical Area)",2019,38687,112300,3576,115876,108724,5434249,140466,85.4,94.7,58.7,95.2,92.9
341,45060,"Syracuse, NY (Metropolitan Statistical Area)",2019,52051,137200,1147,138347,136053,33759608,648593,96,98.9,87.3,97.9,104.6
342,45220,"Tallahassee, FL (Metropolitan Statistical Area)",2019,44232,177600,2973,180573,174627,17127856,387227,93,96.2,84.2,95.1,101.3
343,45300,"Tampa-St. Petersburg-Clearwater, FL (Metropolitan Statistical Area)",2019,48908,193500,1055,194555,192445,156253370,3194831,98.8,93,105.6,100.8,107.6
344,45460,"Terre Haute, IN (Metropolitan Statistical Area)",2019,38851,92900,2582,95482,90318,7240598,186367,85.4,95.2,61.2,91.3,92.9
345,45500,"Texarkana, TX-AR (Metropolitan Statistical Area)",2019,38910,111500,3690,115190,107810,5788318,148761,84.8,95.6,59.6,91.3,92.4
346,45540,"The Villages, FL (Metropolitan Statistical Area)",2019,48387,258600,6058,264658,252542,6407369,132420,95.8,92.5,99.8,95.1,104.3
347,45780,"Toledo, OH (Metropolitan Statistical Area)",2019,48330,130900,1450,132350,129450,31019188,641816,86.2,95.3,64.6,91.3,93.8
348,45820,"Topeka, KS (Metropolitan Statistical Area)",2019,47418,133800,2129,135929,131671,10999549,231969,87.8,94.5,69.7,92,95.6
349,45940,"Trenton-Princeton, NJ (Metropolitan Statistical Area)",2019,71790,291100,4075,295175,287025,26377963,367430,106.2,100.2,121,105.5,115.6
350,46060,"Tucson, AZ (Metropolitan Statistical Area)",2019,45456,184100,1586,185686,182514,47604994,1047279,93.1,93,85.5,99.2,101.3
351,46140,"Tulsa, OK (Metropolitan Statistical Area)",2019,56540,150500,925,151425,149575,56462371,998626,88.6,96.3,72.4,91.3,96.5
352,46220,"Tuscaloosa, AL (Metropolitan Statistical Area)",2019,39738,159500,2330,161830,157170,10015806,252047,86.2,95.9,64.2,90.6,93.9
353,46300,"Twin Falls, ID (Metropolitan Statistical Area)",2019,41899,166400,3626,170026,162774,4662943,111290,89.1,97.7,71.1,93.9,97
354,46340,"Tyler, TX (Metropolitan Statistical Area)",2019,56292,158600,2716,161316,155884,13102118,232751,91.8,96.5,84.9,91.3,100
355,46520,"Urban Honolulu, HI (Metropolitan Statistical Area)",2019,61174,678200,3924,682124,674276,59617709,974563,123.8,114.2,168.3,106.4,134.7
356,46540,"Utica-Rome, NY (Metropolitan Statistical Area)",2019,46151,122200,1647,123847,120553,13383291,289990,92.7,98.9,74.1,97.9,101
357,46660,"Valdosta, GA (Metropolitan Statistical Area)",2019,37623,132100,4159,136259,127941,5541534,147292,85.4,92.5,64.7,95,93
358,46700,"Vallejo, CA (Metropolitan Statistical Area)",2019,53505,406900,4055,410955,402845,23951255,447643,118.3,109.3,147.6,110.5,128.8
359,47020,"Victoria, TX (Metropolitan Statistical Area)",2019,48681,142500,5798,148298,136702,4855536,99742,91.1,96.2,82.1,91.3,99.2
360,47220,"Vineland-Bridgeton, NJ (Metropolitan Statistical Area)",2019,41237,162500,2756,165256,159744,6166042,149527,97.3,100.5,88,100.3,106
361,47260,"Virginia Beach-Norfolk-Newport News, VA-NC (Metropolitan Statistical Area) *",2019,52011,245100,1266,246366,243834,92002182,1768901,96.4,96.4,98.6,95.1,105
362,47300,"Visalia, CA (Metropolitan Statistical Area)",2019,42845,205000,3810,208810,201190,19973932,466195,95.2,98.2,81.4,102.2,103.6
363,47380,"Waco, TX (Metropolitan Statistical Area)",2019,41723,138600,3160,141760,135440,11428760,273920,88.8,96,74.6,91.3,96.7
364,47460,"Walla Walla, WA (Metropolitan Statistical Area)",2019,48444,224800,8665,233465,216135,2943477,60760,97.2,102.8,87.3,97.7,105.9
365,47580,"Warner Robins, GA (Metropolitan Statistical Area)",2019,43358,142000,3740,145740,138260,8038908,185409,89.6,96.6,70.7,95.1,97.6
366,47900,"Washington-Arlington-Alexandria, DC-VA-MD-WV (Metropolitan Statistical Area) *",2019,74385,424000,1315,425315,422685,467176430,6280487,117.4,104.4,161.7,107,127.8
367,47940,"Waterloo-Cedar Falls, IA (Metropolitan Statistical Area)",2019,47623,149500,2264,151764,147236,8025590,168522,88.9,94.5,73.8,92,96.8
368,48060,"Watertown-Fort Drum, NY (Metropolitan Statistical Area)",2019,49365,149900,4069,153969,145831,5421948,109834,96.9,98.9,92.6,97.9,105.5
369,48140,"Wausau-Weston, WI (Metropolitan Statistical Area)",2019,51295,153700,1955,155655,151745,8375743,163285,88.2,95.3,69.7,91.2,96.1
370,48260,"Weirton-Steubenville, WV-OH (Metropolitan Statistical Area)",2019,42158,93000,2016,95016,90984,4893403,116074,84,94.5,52.3,93.3,91.5
371,48300,"Wenatchee, WA (Metropolitan Statistical Area)",2019,51023,284100,6140,290240,277960,6154809,120629,99.5,102.8,96.2,97.7,108.4
372,48540,"Wheeling, WV-OH (Metropolitan Statistical Area)",2019,49301,109300,2695,111995,106605,6850224,138948,86,96.6,56.4,95.1,93.7
373,48620,"Wichita, KS (Metropolitan Statistical Area)",2019,52129,139000,1209,140209,137791,33374235,640218,87.9,94.7,70.1,92.2,95.7
374,48660,"Wichita Falls, TX (Metropolitan Statistical Area)",2019,44910,102300,3163,105463,99137,6792844,151254,86.4,96.2,67.3,91.3,94.1
375,48700,"Williamsport, PA (Metropolitan Statistical Area)",2019,44941,155800,2492,158292,153308,5091802,113299,92,98.9,72.5,97.9,100.2
376,48900,"Wilmington, NC (Metropolitan Statistical Area)",2019,45975,233500,3613,237113,229887,13679101,297533,94.4,96,90.8,95.2,102.8
377,49020,"Winchester, VA-WV (Metropolitan Statistical Area) *",2019,49643,232000,4873,236873,227127,6978059,140566,92.5,92.5,88.7,95,100.8
378,49180,"Winston-Salem, NC (Metropolitan Statistical Area)",2019,45904,152400,1516,153916,150884,31031767,676008,88.7,96.6,66.5,95.1,96.6
379,49340,"Worcester, MA-CT (Metropolitan Statistical Area)",2019,57214,269600,1784,271384,267816,54204431,947404,103.1,101,99.7,107.6,112.2
380,49420,"Yakima, WA (Metropolitan Statistical Area)",2019,45757,175900,4227,180127,171673,11479279,250873,94.3,98.2,76.7,102.2,102.6
381,49620,"York-Hanover, PA (Metropolitan Statistical Area)",2019,51585,177100,1682,178782,175418,23164517,449058,95.9,98.9,86.6,97.9,104.4
382,49660,"Youngstown-Warren-Boardman, OH-PA (Metropolitan Statistical Area)",2019,43167,107700,1095,108795,106605,23140742,536081,85.1,95.7,58.9,92.9,92.7
383,49700,"Yuba City, CA (Metropolitan Statistical Area)",2019,45782,268700,4514,273214,264186,8041182,175639,97.2,98.2,89.3,102.2,105.8
384,49740,"Yuma, AZ (Metropolitan Statistical Area) *",2019,36570,127900,3278,131178,124622,7818246,213787,87.8,93,69.3,99.2,95.7
385,10180,"Abilene, TX (Metropolitan Statistical Area)",2018,43585,110100,3327,113427,106773,7459618,171150,90.7,96,81.6,91.3,97.4
386,10420,"Akron, OH (Metropolitan Statistical Area)",2018,49556,144900,1519,146419,143381,34880215,703855,90.2,95.9,76.7,92.2,96.9
387,10500,"Albany, GA (Metropolitan Statistical Area)",2018,38034,114700,3381,118081,111319,5622985,147840,82.8,96,52.9,95.1,88.9
388,10540,"Albany-Lebanon, OR (Metropolitan Statistical Area)",2018,43327,200900,5848,206748,195052,5522081,127451,97.8,102.9,89.8,97.5,104.9
389,10580,"Albany-Schenectady-Troy, NY (Metropolitan Statistical Area)",2018,58443,208200,1739,209939,206461,51561974,882263,99.3,98.9,102.4,97.9,106.5
390,10740,"Albuquerque, NM (Metropolitan Statistical Area) *",2018,42469,186300,1306,187606,184994,38856657,914947,93.6,93,87.7,98.9,100.4
391,10780,"Alexandria, LA (Metropolitan Statistical Area)",2018,43015,133100,4268,137368,128832,6570992,152762,85.6,96.2,63.6,91.3,91.9
392,10900,"Allentown-Bethlehem-Easton, PA-NJ (Metropolitan Statistical Area)",2018,53538,207200,1733,208933,205467,45112429,842626,98.9,99.1,98.1,99.2,106.2
393,11020,"Altoona, PA (Metropolitan Statistical Area)",2018,46539,120300,2363,122663,117937,5701223,122503,89.9,98.9,65,97.9,96.5
394,11100,"Amarillo, TX (Metropolitan Statistical Area)",2018,46374,135500,2220,137720,133280,12261607,264406,91.4,96.3,83.2,91.3,98.1
395,11180,"Ames, IA (Metropolitan Statistical Area)",2018,43785,180400,5616,186016,174784,5389612,123093,92,93.9,90.1,91.3,98.8
396,11260,"Anchorage, AK (Metropolitan Statistical Area)",2018,61825,288400,2398,290798,286002,24583919,397636,107.7,101.7,134.2,100.7,115.6
397,11460,"Ann Arbor, MI (Metropolitan Statistical Area)",2018,58823,246000,2841,248841,243159,21734133,369483,100.5,97.7,115.6,95.8,107.9
398,11500,"Anniston-Oxford, AL (Metropolitan Statistical Area)",2018,36988,113800,3386,117186,110414,4228930,114331,82.5,96.8,52.2,90.6,88.6
399,11540,"Appleton, WI (Metropolitan Statistical Area)",2018,51042,165700,1496,167196,164204,12097566,237011,89.5,95.4,74.1,91.4,96
400,11700,"Asheville, NC (Metropolitan Statistical Area)",2018,45759,208600,2671,211271,205929,21017694,459314,93.4,95.3,88,95.1,100.2
401,12020,"Athens-Clarke County, GA (Metropolitan Statistical Area)",2018,40692,170200,3361,173561,166839,8605032,211468,91.1,96.4,77.6,95.1,97.8
402,12060,"Atlanta-Sandy Springs-Alpharetta, GA (Metropolitan Statistical Area)",2018,53188,199200,1051,200251,198149,316220617,5945303,97.5,98.1,96,98,104.7
403,12100,"Atlantic City-Hammonton, NJ (Metropolitan Statistical Area)",2018,48548,218300,2978,221278,215322,12816209,263989,98.8,100.5,93.4,100.6,106.1
404,12220,"Auburn-Opelika, AL (Metropolitan Statistical Area)",2018,38378,165000,4054,169054,160946,6280809,163656,85.1,92.6,70.5,90,91.4
405,12260,"Augusta-Richmond County, GA-SC (Metropolitan Statistical Area)",2018,42075,139600,2232,141832,137368,25422701,604221,88.8,96.2,69.5,95.1,95.3
406,12420,"Austin-Round Rock-Georgetown, TX (Metropolitan Statistical Area)",2018,59638,261400,1898,263298,259502,129146253,2165497,99.3,96.5,120.7,91.3,106.6
407,12540,"Bakersfield, CA (Metropolitan Statistical Area)",2018,39794,205200,2255,207455,202945,35566558,893758,97.1,98.1,89.4,101.6,104.2
408,12580,"Baltimore-Columbia-Towson, MD (Metropolitan Statistical Area)",2018,62013,292500,1292,293792,291208,173683854,2800743,106,101.8,113.7,104.1,113.8
409,12620,"Bangor, ME (Metropolitan Statistical Area)",2018,41615,140800,2512,143312,138288,6317871,151817,97,99.1,85.5,103.8,104.2
410,12700,"Barnstable Town, MA (Metropolitan Statistical Area)",2018,74714,384100,2941,387041,381159,15949290,213471,106,99.1,122.5,103.8,113.8
411,12940,"Baton Rouge, LA (Metropolitan Statistical Area)",2018,48159,173700,1589,175289,172111,41153342,854526,91,95.6,83.4,91.3,97.7
412,12980,"Battle Creek, MI (Metropolitan Statistical Area)",2018,39160,105300,2186,107486,103114,5249396,134049,87.4,95.4,69.2,91.4,93.9
413,13020,"Bay City, MI (Metropolitan Statistical Area)",2018,42367,100500,2359,102859,98141,4393535,103702,85.3,95.4,60.6,91.4,91.6
414,13140,"Beaumont-Port Arthur, TX (Metropolitan Statistical Area)",2018,44138,108100,2512,110612,105588,17382152,393815,87.5,96.5,67.8,91.3,93.9
415,13220,"Beckley, WV (Metropolitan Statistical Area)",2018,39312,99200,3799,102999,95401,4605556,117154,76.8,92.4,45.8,94.8,82.5
416,13380,"Bellingham, WA (Metropolitan Statistical Area)",2018,49464,318400,5571,323971,312829,11139242,225197,101,98.1,105.2,101.6,108.4
417,13460,"Bend, OR (Metropolitan Statistical Area)",2018,55612,336400,8562,344962,327838,10672155,191905,102.8,102.9,110.2,97.5,110.4
418,13740,"Billings, MT (Metropolitan Statistical Area)",2018,52502,217700,2580,220280,215120,9461062,180203,94.3,93.6,89.5,98.3,101.2
419,13780,"Binghamton, NY (Metropolitan Statistical Area)",2018,44427,116000,1588,117588,114412,10678703,240366,95.1,98.9,84.7,97.9,102.1
420,13820,"Birmingham-Hoover, AL (Metropolitan Statistical Area)",2018,51723,156900,1522,158422,155378,56272785,1087967,88,96.6,69.1,90.5,94.4
421,13900,"Bismarck, ND (Metropolitan Statistical Area)",2018,56743,236500,3318,239818,233182,7278884,128279,92.6,94.7,88.2,92.2,99.4
422,13980,"Blacksburg-Christiansburg, VA (Metropolitan Statistical Area) *",2018,38421,176300,4604,180904,171696,6435256,167492,89.3,92.5,79.1,94.9,95.9
423,14010,"Bloomington, IL (Metropolitan Statistical Area)",2018,49236,161600,1700,163300,159900,8488859,172410,91.8,95.4,85.3,91.4,98.5
424,14020,"Bloomington, IN (Metropolitan Statistical Area)",2018,41888,159800,3227,163027,156573,7041016,168092,91.5,95.3,85.8,91.4,98.2
425,14100,"Bloomsburg-Berwick, PA (Metropolitan Statistical Area)",2018,45625,155700,3252,158952,152448,3807656,83455,92,98.9,71.7,97.9,98.8
426,14260,"Boise City, ID (Metropolitan Statistical Area)",2018,46664,214300,2871,217171,211429,34014138,728911,92.9,93.1,84.4,98.8,99.7
427,14460,"Boston-Cambridge-Newton, MA-NH (Metropolitan Statistical Area)",2018,78923,414700,1730,416430,412970,383529173,4859536,115,103.7,142.2,111.2,123.4
428,14500,"Boulder, CO (Metropolitan Statistical Area) *",2018,73518,462200,4796,466996,457404,23866572,324636,106.2,96.5,147.4,96.7,114
429,14540,"Bowling Green, KY (Metropolitan Statistical Area)",2018,36186,143400,4371,147771,139029,6400089,176864,84.3,92.4,63.1,90.3,90.5
430,14740,"Bremerton-Silverdale-Port Orchard, WA (Metropolitan Statistical Area)",2018,56297,299600,4441,304041,295159,15159557,269276,107.9,106.6,115.8,104.6,115.8
431,14860,"Bridgeport-Stamford-Norwalk, CT (Metropolitan Statistical Area)",2018,117432,422300,4188,426488,418112,110852692,943971,113.2,105.5,138.9,108.7,121.5
432,15180,"Brownsville-Harlingen, TX (Metropolitan Statistical Area)",2018,28940,83300,1318,84618,81982,12216651,422139,82.4,96.5,56.9,91.3,88.4
433,15260,"Brunswick, GA (Metropolitan Statistical Area)",2018,41967,144200,5832,150032,138368,4963920,118282,88.2,92.5,75.1,94.8,94.7
434,15380,"Buffalo-Cheektowaga, NY (Metropolitan Statistical Area)",2018,50261,141500,961,142461,140539,56783377,1129777,94.2,98.9,79.2,97.9,101.1
435,15500,"Burlington, NC (Metropolitan Statistical Area)",2018,39940,147800,2706,150506,145094,6650506,166514,89.4,96.6,70.4,95.1,96
436,15540,"Burlington-South Burlington, VT (Metropolitan Statistical Area)",2018,57041,268800,3072,271872,265728,12545471,219939,106.4,99.1,124.2,103.8,114.2
437,15680,"California-Lexington Park, MD (Metropolitan Statistical Area)",2018,56815,295000,4846,299846,290154,6404219,112720,98.4,92.5,113.4,94.9,105.6
438,15940,"Canton-Massillon, OH (Metropolitan Statistical Area)",2018,44670,130300,1656,131956,128644,17793419,398330,86.1,95.4,62.1,91.4,92.4
439,15980,"Cape Coral-Fort Myers, FL (Metropolitan Statistical Area)",2018,51093,207700,2522,210222,205178,38547795,754470,97.6,96.6,103.6,95.1,104.8
440,16020,"Cape Girardeau, MO-IL (Metropolitan Statistical Area)",2018,42894,143700,3626,147326,140074,4155068,96868,84.3,93.9,64.9,91.3,90.5
441,16060,"Carbondale-Marion, IL (Metropolitan Statistical Area)",2018,40476,109500,3169,112669,106331,5532805,136694,83.8,94.6,61.9,90.6,89.9
442,16180,"Carson City, NV (Metropolitan Statistical Area)",2018,50797,242200,6996,249196,235204,2804115,55202,96.3,97.6,96.9,94,103.4
443,16220,"Casper, WY (Metropolitan Statistical Area)",2018,71324,202600,5772,208372,196828,5647104,79175,94.1,92.9,89.6,99,101.1
444,16300,"Cedar Rapids, IA (Metropolitan Statistical Area)",2018,52261,152600,2107,154707,150493,14218156,272061,88.3,94.6,70.2,92.1,94.8
445,16540,"Chambersburg-Waynesboro, PA (Metropolitan Statistical Area)",2018,46298,175600,3250,178850,172350,7156703,154579,94,98.9,78.8,97.9,100.9
446,16580,"Champaign-Urbana, IL (Metropolitan Statistical Area)",2018,45331,151200,2446,153646,148754,10257582,226284,92,95.3,87.1,91.4,98.7
447,16620,"Charleston, WV (Metropolitan Statistical Area)",2018,44198,106200,2681,108881,103519,11503784,260280,86.3,95.2,58.6,95.1,92.7
448,16700,"Charleston-North Charleston, SC (Metropolitan Statistical Area)",2018,51202,221800,2686,224486,219114,40353521,788122,96.7,96.6,99.3,95.1,103.8
449,16740,"Charlotte-Concord-Gastonia, NC-SC (Metropolitan Statistical Area)",2018,52295,187700,1049,188749,186651,135599272,2592950,94.1,96.2,88.1,95.1,101
450,16820,"Charlottesville, VA (Metropolitan Statistical Area) *",2018,67735,272500,4926,277426,267574,14721107,217335,98.9,96.4,112.7,95.1,106.2
451,16860,"Chattanooga, TN-GA (Metropolitan Statistical Area)",2018,46055,156800,1409,158209,155391,25828981,560832,88.1,96.6,71,90.5,94.6
452,16940,"Cheyenne, WY (Metropolitan Statistical Area)",2018,52655,214000,4447,218447,209553,5205696,98865,93.7,92.9,88.1,99,100.6
453,16980,"Chicago-Naperville-Elgin, IL-IN-WI (Metropolitan Statistical Area)",2018,61642,231400,603,232003,230797,584625041,9484158,102.9,100.2,113.3,100.2,110.4
454,17020,"Chico, CA (Metropolitan Statistical Area)",2018,44576,248100,5149,253249,242951,10267576,230339,100.4,98.1,102.7,101.6,107.8
455,17140,"Cincinnati, OH-KY-IN (Metropolitan Statistical Area)",2018,54055,163100,749,163849,162351,119565639,2211936,90.7,96,78.6,92.5,97.4
456,17300,"Clarksville, TN-KY (Metropolitan Statistical Area)",2018,40488,149500,2828,152328,146672,12320446,304301,88.4,96.5,74.5,90.5,94.9
457,17420,"Cleveland, TN (Metropolitan Statistical Area)",2018,38594,150100,3681,153781,146419,4784442,123968,84.6,92.6,67,90.1,90.8
458,17460,"Cleveland-Elyria, OH (Metropolitan Statistical Area)",2018,53770,146800,761,147561,146039,110433483,2053795,90.2,95.9,77,92.2,96.8
459,17660,"Coeur d'Alene, ID (Metropolitan Statistical Area)",2018,45409,237400,5448,242848,231952,7320336,161209,94.2,97.6,89.1,94,101.2
460,17780,"College Station-Bryan, TX (Metropolitan Statistical Area)",2018,40498,172400,3841,176241,168559,10583596,261335,92.3,96.1,88.1,91.3,99
461,17820,"Colorado Springs, CO (Metropolitan Statistical Area)",2018,49007,255200,2525,257725,252675,36128371,737202,98.5,93.1,108.5,98.8,105.7
462,17860,"Columbia, MO (Metropolitan Statistical Area)",2018,45512,179800,5780,185580,174020,9409471,206746,89.2,94.8,74.7,92.2,95.8
463,17900,"Columbia, SC (Metropolitan Statistical Area)",2018,44915,149700,1403,151103,148297,37355418,831690,91.7,96.2,79.3,95.1,98.4
464,17980,"Columbus, GA-AL (Metropolitan Statistical Area)",2018,40980,144500,3440,147940,141060,13040174,318211,88.8,96.2,70.3,95.1,95.3
465,18020,"Columbus, IN (Metropolitan Statistical Area)",2018,51234,143800,3323,147123,140477,4238170,82722,89.4,94.6,80.1,90.5,95.9
466,18140,"Columbus, OH (Metropolitan Statistical Area)",2018,51114,173500,936,174436,172564,107553917,2104194,91.7,95.3,84.8,91.4,98.4
467,18580,"Corpus Christi, TX (Metropolitan Statistical Area)",2018,43677,129900,2231,132131,127669,18724313,428697,92.5,96.5,87.6,91.3,99.3
468,18700,"Corvallis, OR (Metropolitan Statistical Area)",2018,47070,303200,7940,311140,295260,4351272,92442,103.4,102.9,112.5,97.5,111
469,18880,"Crestview-Fort Walton Beach-Destin, FL (Metropolitan Statistical Area)",2018,53010,211000,4126,215126,206874,14719045,277666,94.3,94.4,92.7,95.1,101.3
470,19060,"Cumberland, MD-WV (Metropolitan Statistical Area)",2018,39757,122700,3481,126181,119219,3891961,97894,85.9,96.6,60.5,95.1,92.3
471,19100,"Dallas-Fort Worth-Arlington, TX (Metropolitan Statistical Area)",2018,56864,193100,749,193849,192351,423961883,7455756,100.7,98.9,108.2,98.4,108.1
472,19140,"Dalton, GA (Metropolitan Statistical Area)",2018,36697,121200,3194,124394,118006,5291383,144192,84.5,92.4,62.6,94.8,90.7
473,19180,"Danville, IL (Metropolitan Statistical Area)",2018,39177,78900,2037,80937,76863,3004944,76702,78.9,94.6,52.1,90.5,84.8
474,19300,"Daphne-Fairhope-Foley, AL (Metropolitan Statistical Area)",2018,46205,189800,4020,193820,185780,10065966,217855,89.7,96.8,80.2,90.5,96.2
475,19340,"Davenport-Moline-Rock Island, IA-IL (Metropolitan Statistical Area)",2018,49118,132600,1792,134392,130808,18667082,380044,88.5,94.7,71.7,92.2,95
476,19460,"Decatur, AL (Metropolitan Statistical Area)",2018,38894,125100,3297,128397,121803,5917497,152144,82.8,96.8,52.2,90.6,88.9
477,19500,"Decatur, IL (Metropolitan Statistical Area)",2018,48206,96800,2089,98889,94711,5037722,104504,85,95.4,59.2,91.4,91.3
478,19660,"Deltona-Daytona Beach-Ormond Beach, FL (Metropolitan Statistical Area)",2018,43467,170600,1617,172217,168983,28609503,658186,95.8,96.6,95.4,95.2,102.8
479,19740,"Denver-Aurora-Lakewood, CO (Metropolitan Statistical Area) *",2018,64690,350500,1238,351738,349262,189649107,2931665,104.4,98.1,136.9,95.9,112.1
480,19780,"Des Moines-West Des Moines, IA (Metropolitan Statistical Area)",2018,53884,176300,2153,178453,174147,37229450,690915,92.4,94.7,87.9,92.2,99.2
481,19820,"Detroit-Warren-Dearborn, MI (Metropolitan Statistical Area)",2018,52572,160600,636,161236,159964,227218784,4322084,95.2,97.8,85.9,97.8,102.2
482,20020,"Dothan, AL (Metropolitan Statistical Area)",2018,41761,121400,2810,124210,118590,6191069,148249,83.3,95.9,56.3,90.5,89.5
483,20100,"Dover, DE (Metropolitan Statistical Area)",2018,41638,213900,3895,217795,210005,7434085,178540,92.1,96.6,81.5,95.1,98.9
484,20220,"Dubuque, IA (Metropolitan Statistical Area)",2018,50120,160900,2507,163407,158393,4857757,96922,89.4,94.7,74.4,92.2,95.9
485,20260,"Duluth, MN-WI (Metropolitan Statistical Area)",2018,46004,153000,1392,154392,151608,13307077,289260,89.7,94.7,77.5,92.2,96.3
486,20500,"Durham-Chapel Hill, NC (Metropolitan Statistical Area)",2018,52727,223000,3306,226306,219694,33613793,637501,94.7,95.7,91.7,95.2,101.7
487,20700,"East Stroudsburg, PA (Metropolitan Statistical Area)",2018,42267,167000,2382,169382,164618,7155522,169294,96.5,98.9,90.6,97.9,103.6
488,20740,"Eau Claire, WI (Metropolitan Statistical Area)",2018,47600,160500,2116,162616,158384,8018914,168464,89.1,95.4,74.4,91.4,95.7
489,20940,"El Centro, CA (Metropolitan Statistical Area)",2018,37587,177100,6144,183244,170956,6822928,181523,90.8,102.9,69,97.5,97.5
490,21060,"Elizabethtown-Fort Knox, KY (Metropolitan Statistical Area)",2018,41460,148900,3757,152657,145143,6351661,153201,85.5,92.6,71.3,90,91.8
491,21140,"Elkhart-Goshen, IN (Metropolitan Statistical Area)",2018,46354,137900,2301,140201,135599,9531126,205617,88.5,95.4,71.4,91.4,95
492,21300,"Elmira, NY (Metropolitan Statistical Area)",2018,44510,106500,3145,109645,103355,3735959,83935,94.9,98.9,83.2,97.9,101.8
493,21340,"El Paso, TX (Metropolitan Statistical Area)",2018,36279,118900,970,119870,117930,30533172,841613,87.9,96.5,73.8,91.3,94.4
494,21420,"Enid, OK (Metropolitan Statistical Area)",2018,43667,106800,5477,112277,101323,2667845,61095,89,96.5,73.6,91.3,95.5
495,21500,"Erie, PA (Metropolitan Statistical Area)",2018,45038,130000,2060,132060,127940,12229735,271544,91.7,98.9,71.3,97.9,98.4
496,21660,"Eugene-Springfield, OR (Metropolitan Statistical Area)",2018,46124,246500,2693,249193,243807,17460343,378549,99.2,98.1,97.7,101.6,106.5
497,21780,"Evansville, IN-KY (Metropolitan Statistical Area)",2018,47067,136500,1710,138210,134790,14810042,314660,87.8,95.4,68.2,91.4,94.3
498,21820,"Fairbanks, AK (Metropolitan Statistical Area) *",2018,57720,236800,8101,244901,228699,5689172,98565,107.9,101.1,141.9,98.1,115.9
499,22020,"Fargo, ND-MN (Metropolitan Statistical Area)",2018,53315,201700,3835,205535,197865,13025395,244311,91.2,94.7,82.7,92.2,97.9
500,22140,"Farmington, NM (Metropolitan Statistical Area)",2018,35278,150400,3959,154359,146441,4427385,125499,90.8,97.6,75,94,97.4
501,22180,"Fayetteville, NC (Metropolitan Statistical Area)",2018,36874,133700,2294,135994,131406,19265143,522461,88.7,95.4,73.5,95.1,95.2
502,22220,"Fayetteville-Springdale-Rogers, AR (Metropolitan Statistical Area)",2018,66909,165800,1746,167546,164054,35143183,525239,88.1,96.4,69.5,91.3,94.5
503,22380,"Flagstaff, AZ (Metropolitan Statistical Area)",2018,48870,261300,7240,268540,254060,6965148,142523,98.2,97.6,104.8,94,105.4
504,22420,"Flint, MI (Metropolitan Statistical Area)",2018,40618,104800,1458,106258,103342,16518658,406688,89.2,97.7,66.6,95.8,95.7
505,22500,"Florence, SC (Metropolitan Statistical Area)",2018,40598,114700,3354,118054,111346,8324125,205036,86.8,95.6,62,95.1,93.2
506,22520,"Florence-Muscle Shoals, AL (Metropolitan Statistical Area)",2018,37797,127500,3803,131303,123697,5579182,147608,81.6,96.8,48.9,90.6,87.7
507,22540,"Fond du Lac, WI (Metropolitan Statistical Area)",2018,48311,152900,2297,155197,150603,4976108,103001,87.5,94.6,73,90.5,94
508,22660,"Fort Collins, CO (Metropolitan Statistical Area)",2018,54207,336200,3392,339592,332808,19008370,350660,101.3,92.9,123.3,99,108.7
509,22900,"Fort Smith, AR-OK (Metropolitan Statistical Area)",2018,37120,110300,1902,112202,108398,9291140,250298,82.9,96.3,55,91.3,89
510,23060,"Fort Wayne, IN (Metropolitan Statistical Area)",2018,46478,124700,1422,126122,123278,19015375,409126,88.5,95.4,70.7,91.4,95
511,23420,"Fresno, CA (Metropolitan Statistical Area)",2018,43438,237500,2246,239746,235254,43088095,991950,97.1,98.1,89.4,101.6,104.3
512,23460,"Gadsden, AL (Metropolitan Statistical Area)",2018,37245,109900,4064,113964,105836,3821755,102611,81.7,96.8,49.8,90.6,87.7
513,23540,"Gainesville, FL (Metropolitan Statistical Area)",2018,43291,169100,2859,171959,166241,14196596,327933,94.1,95.4,90.4,95.1,101.1
514,23580,"Gainesville, GA (Metropolitan Statistical Area)",2018,44442,183200,5259,188459,177941,8956711,201538,90.6,92.5,82.3,94.8,97.2
515,23900,"Gettysburg, PA (Metropolitan Statistical Area)",2018,48379,201900,3704,205604,198196,4986055,103062,95.5,98.9,85.7,97.9,102.5
516,24020,"Glens Falls, NY (Metropolitan Statistical Area)",2018,46633,168800,2954,171754,165846,5851973,125489,96.4,98.9,89.5,97.9,103.5
517,24140,"Goldsboro, NC (Metropolitan Statistical Area)",2018,38425,121900,4583,126483,117317,4735428,123237,86.9,96.6,62.7,95.1,93.3
518,24220,"Grand Forks, ND-MN (Metropolitan Statistical Area)",2018,50258,180500,3969,184469,176531,5114605,101766,90.7,94.7,81.5,92.2,97.4
519,24260,"Grand Island, NE (Metropolitan Statistical Area)",2018,43859,136800,3017,139817,133783,3310290,75476,84.7,93.9,63.3,91.2,91
520,24300,"Grand Junction, CO (Metropolitan Statistical Area)",2018,45405,214400,3425,217825,210975,6944767,152951,93,97.6,85.1,94,99.8
521,24340,"Grand Rapids-Kentwood, MI (Metropolitan Statistical Area)",2018,49054,164300,800,165100,163500,52555045,1071370,92,95.3,86.2,91.4,98.7
522,24420,"Grants Pass, OR (Metropolitan Statistical Area)",2018,41909,251000,8320,259320,242680,3652347,87150,94.2,102.9,79.1,97.5,101.1
523,24500,"Great Falls, MT (Metropolitan Statistical Area)",2018,47889,171700,2855,174555,168845,3911977,81688,91.8,92.9,80.1,99,98.5
524,24540,"Greeley, CO (Metropolitan Statistical Area) *",2018,48035,269400,3539,272939,265861,15122272,314815,96.9,96.5,97.8,96.7,104
525,24580,"Green Bay, WI (Metropolitan Statistical Area)",2018,51575,164900,1281,166181,163619,16575483,321384,89.7,95.3,76.1,91.3,96.2
526,24660,"Greensboro-High Point, NC (Metropolitan Statistical Area)",2018,43437,145900,1226,147126,144674,33293181,766473,89.7,96.3,71.1,95.1,96.3
527,24780,"Greenville, NC (Metropolitan Statistical Area)",2018,41841,141100,3696,144796,137404,7513687,179575,87,96.6,65.2,95.1,93.3
528,24860,"Greenville-Anderson, SC (Metropolitan Statistical Area)",2018,44269,154600,1351,155951,153249,40152888,907028,90.2,96.4,73.3,95.1,96.9
529,25060,"Gulfport-Biloxi, MS (Metropolitan Statistical Area)",2018,36827,139100,2888,141988,136212,15271584,414686,87.1,96.6,69.8,90.5,93.5
530,25180,"Hagerstown-Martinsburg, MD-WV (Metropolitan Statistical Area)",2018,43824,191000,3087,194087,187913,12521492,285722,96.3,99.2,80.6,105,103.3
531,25220,"Hammond, LA (Metropolitan Statistical Area)",2018,37713,154000,4852,158852,149148,5047372,133837,85.5,92.4,71.4,90.8,91.8
532,25260,"Hanford-Corcoran, CA (Metropolitan Statistical Area)",2018,36961,202800,4445,207245,198355,5595305,151382,96.4,102.9,85,97.5,103.5
533,25420,"Harrisburg-Carlisle, PA (Metropolitan Statistical Area)",2018,52209,179500,1811,181311,177689,29975666,574149,96,98.9,87.4,97.9,103.1
534,25500,"Harrisonburg, VA (Metropolitan Statistical Area) *",2018,40328,206400,5010,211410,201390,5434131,134749,90.6,92.5,83,94.9,97.3
535,25540,"Hartford-East Hartford-Middletown, CT (Metropolitan Statistical Area)",2018,63446,246600,1271,247871,245329,76525205,1206139,102.7,99.2,107.1,103.9,110.2
536,25620,"Hattiesburg, MS (Metropolitan Statistical Area)",2018,38306,142400,6213,148613,136187,6446610,168292,83.8,92.5,64.7,90.2,90
537,25860,"Hickory-Lenoir-Morganton, NC (Metropolitan Statistical Area)",2018,39527,128200,1940,130140,126260,14563744,368449,87.4,96.6,61.7,95.1,93.8
538,25940,"Hilton Head Island-Bluffton, SC (Metropolitan Statistical Area)",2018,53610,273600,6087,279687,267513,11688294,218023,95.3,92.5,99.9,94.9,102.3
539,25980,"Hinesville, GA (Metropolitan Statistical Area)",2018,34371,120800,4817,125617,115983,2739287,79697,91.5,92.5,87.4,94.9,98.3
540,26140,"Homosassa Springs, FL (Metropolitan Statistical Area)",2018,38021,123800,3817,127617,119983,5615058,147682,88.7,92.5,78.5,94.9,95.2
541,26300,"Hot Springs, AR (Metropolitan Statistical Area)",2018,39578,138400,6016,144416,132384,3916903,98966,85.2,92.4,71,90.8,91.5
542,26380,"Houma-Thibodaux, LA (Metropolitan Statistical Area)",2018,42584,150300,3650,153950,146650,8906282,209144,88.5,96.5,72.5,91.3,95
543,26420,"Houston-The Woodlands-Sugar Land, TX (Metropolitan Statistical Area)",2018,57154,179100,877,179977,178223,398715792,6976147,101.7,95.6,104.6,106.8,109.2
544,26580,"Huntington-Ashland, WV-KY-OH (Metropolitan Statistical Area)",2018,40368,116400,2312,118712,114088,14494768,359069,85.6,96,56.9,94.9,91.9
545,26620,"Huntsville, AL (Metropolitan Statistical Area)",2018,50199,174000,2083,176083,171917,23251202,463181,88.5,96.8,69.3,90.6,95
546,26820,"Idaho Falls, ID (Metropolitan Statistical Area)",2018,46113,169000,2439,171439,166561,6844788,148436,90.9,97.7,75.9,94,97.6
547,26900,"Indianapolis-Carmel-Anderson, IN (Metropolitan Statistical Area)",2018,54778,155000,878,155878,154122,112423871,2052368,91.3,95.3,83.5,91.4,98
548,26980,"Iowa City, IA (Metropolitan Statistical Area)",2018,54803,205800,4259,210059,201541,9459396,172607,93.5,94.7,93.4,92.2,100.3
549,27060,"Ithaca, NY (Metropolitan Statistical Area)",2018,45120,199400,5416,204816,193984,4621168,102419,105.2,98.9,132.2,97.9,112.9
550,27100,"Jackson, MI (Metropolitan Statistical Area)",2018,39173,124100,3136,127236,120964,6211490,158566,87.7,95.4,68.9,91.4,94.2
551,27140,"Jackson, MS (Metropolitan Statistical Area)",2018,43496,143900,1955,145855,141945,25983190,597376,88.6,96.3,72.8,90.5,95.1
552,27180,"Jackson, TN (Metropolitan Statistical Area)",2018,40178,121400,3204,124604,118196,7164271,178315,80.8,92.4,56.1,90.2,86.7
553,27260,"Jacksonville, FL (Metropolitan Statistical Area)",2018,50321,188700,1843,190543,186857,77124644,1532663,95.3,96.5,93.5,95.1,102.3
554,27340,"Jacksonville, NC (Metropolitan Statistical Area)",2018,46377,153900,2911,156811,150989,9132278,196915,92,96.6,82.8,95.2,98.8
555,27500,"Janesville-Beloit, WI (Metropolitan Statistical Area)",2018,44295,139800,2022,141822,137778,7214503,162874,89.6,95.4,76.3,91.4,96.2
556,27620,"Jefferson City, MO (Metropolitan Statistical Area)",2018,42199,151500,3072,154572,148428,6393650,151512,82.1,93.9,55.4,91.2,88.1
557,27740,"Johnson City, TN (Metropolitan Statistical Area)",2018,40256,144200,3014,147214,141186,8167988,202900,85.3,96.8,61.3,90.5,91.6
558,27780,"Johnstown, PA (Metropolitan Statistical Area)",2018,43445,90900,2128,93028,88772,5710818,131449,85.8,98.9,51.3,97.9,92.1
559,27860,"Jonesboro, AR (Metropolitan Statistical Area)",2018,36515,124100,4985,129085,119115,4846214,132719,83,92.4,64,90.8,89.1
560,27900,"Joplin, MO (Metropolitan Statistical Area)",2018,40320,117900,2483,120383,115417,7201720,178613,84.9,94.7,58.5,92.2,91.2
561,27980,"Kahului-Wailuku-Lahaina, HI (Metropolitan Statistical Area)",2018,49157,599500,10723,610223,588777,8212150,167058,112,105.7,138.4,100,120.2
562,28020,"Kalamazoo-Portage, MI (Metropolitan Statistical Area)",2018,48279,149300,1960,151260,147340,12778555,264680,90.1,95.4,78.7,91.4,96.7
563,28100,"Kankakee, IL (Metropolitan Statistical Area)",2018,41387,144200,3227,147427,140973,4550632,109953,92.7,97.2,76.6,99,99.5
564,28140,"Kansas City, MO-KS (Metropolitan Statistical Area)",2018,53484,173500,880,174380,172620,114691816,2144427,92.7,95.7,82.7,95.2,99.5
565,28420,"Kennewick-Richland, WA (Metropolitan Statistical Area)",2018,44548,207800,3040,210840,204760,13154449,295289,98,98.1,92.3,101.6,105.2
566,28660,"Killeen-Temple, TX (Metropolitan Statistical Area)",2018,41661,136200,2104,138304,134096,18800567,451272,89.4,96.4,77.6,91.3,96
567,28700,"Kingsport-Bristol, TN-VA (Metropolitan Statistical Area) *",2018,40195,127500,2161,129661,125339,12329340,306736,84.4,96.7,56.7,91.6,90.6
568,28740,"Kingston, NY (Metropolitan Statistical Area)",2018,50590,225500,3591,229091,221909,9026113,178418,102.6,98.9,118.7,97.9,110.1
569,28940,"Knoxville, TN (Metropolitan Statistical Area)",2018,46360,163600,1290,164890,162310,39926820,861234,88,96.3,70.1,90.5,94.5
570,29020,"Kokomo, IN (Metropolitan Statistical Area)",2018,42140,106300,3504,109804,102796,3466287,82257,85.6,95.4,61.2,91.4,91.9
571,29100,"La Crosse-Onalaska, WI-MN (Metropolitan Statistical Area)",2018,50445,167200,1834,169034,165366,6891419,136613,91.1,95.4,82.8,91.4,97.8
572,29180,"Lafayette, LA (Metropolitan Statistical Area)",2018,43518,151700,2233,153933,149467,21309936,489680,85.9,95.8,65.3,91.3,92.2
573,29200,"Lafayette-West Lafayette, IN (Metropolitan Statistical Area)",2018,39645,143500,2741,146241,140759,9155463,230938,89.7,95.2,77.9,91.3,96.3
574,29340,"Lake Charles, LA (Metropolitan Statistical Area)",2018,48547,147800,3814,151614,143986,10204086,210190,88.2,96.4,71.2,91.3,94.6
575,29420,"Lake Havasu City-Kingman, AZ (Metropolitan Statistical Area)",2018,33354,151100,3785,154885,147315,6980623,209292,89.4,92.9,73.5,99,96
576,29460,"Lakeland-Winter Haven, FL (Metropolitan Statistical Area)",2018,35789,135400,2570,137970,132830,25288404,706597,93.1,96.6,85,95.1,99.9
577,29540,"Lancaster, PA (Metropolitan Statistical Area)",2018,52591,200400,2260,202660,198140,28608117,543969,98.3,98.9,97.7,97.9,105.5
578,29620,"Lansing-East Lansing, MI (Metropolitan Statistical Area)",2018,41202,144000,1754,145754,142246,22606483,548674,91,95.3,82.2,91.4,97.7
579,29700,"Laredo, TX (Metropolitan Statistical Area)",2018,31491,119900,2557,122457,117343,8663833,275120,86.7,96.5,68.6,91.3,93
580,29740,"Las Cruces, NM (Metropolitan Statistical Area)",2018,36192,141700,4707,146407,136993,7863764,217278,86.7,92.9,65.9,99,93.1
581,29820,"Las Vegas-Henderson-Paradise, NV (Metropolitan Statistical Area)",2018,47759,238300,1220,239520,237080,106317025,2226115,96.1,92.9,98,99,103.2
582,29940,"Lawrence, KS (Metropolitan Statistical Area)",2018,43939,192800,4087,196887,188713,5321380,121109,91.7,94.7,85.3,92.2,98.4
583,30020,"Lawton, OK (Metropolitan Statistical Area)",2018,40845,122300,3495,125795,118805,5160729,126348,88,96.1,71.6,91.4,94.5
584,30140,"Lebanon, PA (Metropolitan Statistical Area)",2018,47557,169200,2200,171400,167000,6721612,141339,95.4,98.9,84.9,97.9,102.4
585,30300,"Lewiston, ID-WA (Metropolitan Statistical Area)",2018,46235,181400,4759,186159,176641,2906903,62872,90.2,97.6,73.2,94,96.8
586,30340,"Lewiston-Auburn, ME (Metropolitan Statistical Area)",2018,41375,153500,2797,156297,150703,4464983,107914,96,99.1,81,103.8,103.1
587,30460,"Lexington-Fayette, KY (Metropolitan Statistical Area)",2018,48023,174300,1618,175918,172682,24729052,514938,89.9,96.8,76.2,90.5,96.5
588,30620,"Lima, OH (Metropolitan Statistical Area)",2018,42575,113500,2680,116180,110820,4373564,102725,83.9,95.4,56.1,91.4,90.1
589,30700,"Lincoln, NE (Metropolitan Statistical Area)",2018,49548,167500,1638,169138,165862,16539079,333800,90.9,94.7,81.3,92.2,97.6
590,30780,"Little Rock-North Little Rock-Conway, AR (Metropolitan Statistical Area)",2018,45070,150500,1457,151957,149043,33355595,740081,88.5,96.4,71.8,91.3,95
591,30860,"Logan, UT-ID (Metropolitan Statistical Area)",2018,39861,216200,3836,220036,212364,5584640,140104,91,97.6,76.9,94,97.7
592,30980,"Longview, TX (Metropolitan Statistical Area)",2018,41805,126700,4451,131151,122249,11927686,285315,89.1,96,75.1,91.3,95.6
593,31020,"Longview, WA (Metropolitan Statistical Area)",2018,44923,197000,3316,200316,193684,4885518,108752,95.9,102.9,83.3,97.5,102.9
594,31080,"Los Angeles-Long Beach-Anaheim, CA (Metropolitan Statistical Area)",2018,63886,579500,1500,581000,578000,846486801,13249879,118.3,105.7,167.5,106.9,127
595,31140,"Louisville/Jefferson County, KY-IN (Metropolitan Statistical Area)",2018,50437,161800,888,162688,160912,63652743,1262023,89.5,96.5,75,90.5,96.1
596,31180,"Lubbock, TX (Metropolitan Statistical Area)",2018,42854,127500,2834,130334,124666,13680735,319239,91.4,96.3,83.6,91.3,98.1
597,31340,"Lynchburg, VA (Metropolitan Statistical Area) *",2018,40394,167300,2000,169300,165300,10619217,262893,89.2,96.4,69.4,95.1,95.7
598,31420,"Macon-Bibb County, GA (Metropolitan Statistical Area)",2018,40967,119200,3387,122587,115813,9405674,229594,87.1,95.9,63.4,95.1,93.5
599,31460,"Madera, CA (Metropolitan Statistical Area)",2018,39094,235200,5350,240550,229850,6133070,156882,94.7,98.1,81,101.6,101.7
600,31540,"Madison, WI (Metropolitan Statistical Area)",2018,59591,238800,1460,240260,237340,39325386,659927,96.3,95.3,109,91.3,103.4
601,31700,"Manchester-Nashua, NH (Metropolitan Statistical Area)",2018,61111,265000,2253,267253,262747,25338570,414630,108,101.2,119.8,108,116
602,31740,"Manhattan, KS (Metropolitan Statistical Area)",2018,45181,190300,4558,194858,185742,5950233,131698,91.3,93.9,87.9,91.3,98
603,31860,"Mankato, MN (Metropolitan Statistical Area)",2018,46614,179500,2624,182124,176876,4734877,101577,91.6,93.9,88.4,91.3,98.3
604,31900,"Mansfield, OH (Metropolitan Statistical Area)",2018,39393,105600,3227,108827,102373,4766061,120987,84.5,95.4,57.6,91.4,90.7
605,32580,"McAllen-Edinburg-Mission, TX (Metropolitan Statistical Area)",2018,26615,84000,1115,85115,82885,22949668,862298,82.1,96.5,56.1,91.3,88.1
606,32780,"Medford, OR (Metropolitan Statistical Area)",2018,46661,261700,4018,265718,257682,10237971,219411,98,98.1,93.2,101.6,105.2
607,32820,"Memphis, TN-MS-AR (Metropolitan Statistical Area)",2018,46677,144300,1557,145857,142743,62663644,1342497,89.5,96.6,76,90.5,96.1
608,32900,"Merced, CA (Metropolitan Statistical Area)",2018,39018,229500,5335,234835,224165,10696798,274151,95.7,98.1,83.7,101.6,102.7
609,33100,"Miami-Fort Lauderdale-Pompano Beach, FL (Metropolitan Statistical Area)",2018,59151,259300,1300,260600,258000,363413990,6143837,111,103.3,130.6,105.5,119.2
610,33140,"Michigan City-La Porte, IN (Metropolitan Statistical Area)",2018,42363,127700,3243,130943,124457,4659156,109981,85.2,94.6,66.5,90.5,91.5
611,33220,"Midland, MI (Metropolitan Statistical Area)",2018,54371,137600,3047,140647,134553,4524934,83223,90.3,95.4,78.4,91.4,97
612,33260,"Midland, TX (Metropolitan Statistical Area)",2018,127283,195000,5991,200991,189009,22679972,178186,98.4,96.3,120.2,91.3,105.6
613,33340,"Milwaukee-Waukesha, WI (Metropolitan Statistical Area)",2018,57034,204700,1164,205864,203536,89771409,1573995,94.7,96.3,92.6,94.1,101.7
614,33460,"Minneapolis-St. Paul-Bloomington, MN-WI (Metropolitan Statistical Area)",2018,62914,242800,713,243513,242087,227122134,3610061,102.8,105,110.6,97,110.4
615,33540,"Missoula, MT (Metropolitan Statistical Area)",2018,49798,271400,4967,276367,266433,5908024,118640,94.7,97.6,90.6,94,101.6
616,33660,"Mobile, AL (Metropolitan Statistical Area)",2018,38709,126600,1798,128398,124802,16657010,430310,85.3,96.4,62.3,90.6,91.6
617,33700,"Modesto, CA (Metropolitan Statistical Area)",2018,43631,272400,2718,275118,269682,23915119,548126,100.2,98.1,101.9,101.6,107.5
618,33740,"Monroe, LA (Metropolitan Statistical Area)",2018,40812,133900,5270,139170,128630,8249670,202138,83.6,95.8,57.9,91.3,89.8
619,33780,"Monroe, MI (Metropolitan Statistical Area)",2018,46881,155700,2433,158133,153267,7040382,150174,91.1,97.7,73.7,95.8,97.8
620,33860,"Montgomery, AL (Metropolitan Statistical Area)",2018,43365,137700,2449,140149,135251,16175960,373022,87.5,96.7,69.1,90.5,94
621,34060,"Morgantown, WV (Metropolitan Statistical Area)",2018,43231,160900,3473,164373,157427,6017885,139204,90.2,92.5,81,94.8,96.8
622,34100,"Morristown, TN (Metropolitan Statistical Area)",2018,36425,136400,3274,139674,133126,5164293,141778,81.8,92.6,59.7,90.1,87.8
623,34580,"Mount Vernon-Anacortes, WA (Metropolitan Statistical Area)",2018,52072,286200,4576,290776,281624,6656585,127835,101.6,102.9,105.2,97.5,109.1
624,34620,"Muncie, IN (Metropolitan Statistical Area)",2018,36942,90900,2548,93448,88352,4222330,114297,85.9,95.4,64.8,91.4,92.2
625,34740,"Muskegon, MI (Metropolitan Statistical Area)",2018,38289,111000,1945,112945,109055,6646850,173599,86.8,95.4,66.1,91.4,93.1
626,34820,"Myrtle Beach-Conway-North Myrtle Beach, SC-NC (Metropolitan Statistical Area)",2018,39355,179300,2243,181543,177057,18928980,480985,91.8,95.5,84.4,95.1,98.6
627,34900,"Napa, CA (Metropolitan Statistical Area)",2018,72043,603700,7439,611139,596261,9998840,138789,120.8,109.5,159.5,110.5,129.7
628,34940,"Naples-Marco Island, FL (Metropolitan Statistical Area)",2018,98303,340100,5227,345327,334873,37178408,378201,101.5,96.6,126.8,95.1,108.9
629,34980,"Nashville-Davidson--Murfreesboro--Franklin, TN (Metropolitan Statistical Area)",2018,58779,217500,1487,218987,216013,111957997,1904726,94.1,96.6,96,90.5,101.1
630,35100,"New Bern, NC (Metropolitan Statistical Area)",2018,43517,152200,4297,156497,147903,5421548,124584,84.3,92.5,65.3,94.9,90.5
631,35300,"New Haven-Milford, CT (Metropolitan Statistical Area)",2018,55779,246700,2033,248733,244667,47801068,856971,107,104,110.4,107.8,114.9
632,35380,"New Orleans-Metairie, LA (Metropolitan Statistical Area)",2018,52963,190000,1387,191387,188613,67270399,1270133,93.3,96.4,91.2,91.3,100.1
633,35620,"New York-Newark-Jersey City, NY-NJ-PA (Metropolitan Statistical Area)",2018,76565,426100,889,426989,425211,1475920082,19276644,125.3,109.9,152.9,123.3,134.5
634,35660,"Niles, MI (Metropolitan Statistical Area)",2018,47461,146300,2896,149196,143404,7299007,153790,86.9,95.4,66.2,91.4,93.3
635,35840,"North Port-Sarasota-Bradenton, FL (Metropolitan Statistical Area)",2018,57104,228200,2442,230642,225758,46866563,820716,100.3,96.6,116.3,95.2,107.7
636,35980,"Norwich-New London, CT (Metropolitan Statistical Area)",2018,57912,239000,3131,242131,235869,15421095,266285,102.9,99.1,108.2,103.8,110.5
637,36100,"Ocala, FL (Metropolitan Statistical Area)",2018,37219,127100,3278,130378,123822,13363961,359062,91,96.6,77.5,95.1,97.6
638,36140,"Ocean City, NJ (Metropolitan Statistical Area)",2018,60264,296600,4925,301525,291675,5571180,92446,101.7,100.5,105.5,100.6,109.2
639,36220,"Odessa, TX (Metropolitan Statistical Area)",2018,48449,133900,5496,139396,128404,7846736,161960,93.7,96.5,92.8,91.3,100.6
640,36260,"Ogden-Clearfield, UT (Metropolitan Statistical Area)",2018,44096,235700,1885,237585,233815,29705915,673660,93.6,93.4,87.2,98.6,100.5
641,36420,"Oklahoma City, OK (Metropolitan Statistical Area)",2018,47607,151900,1005,152905,150895,66345545,1393605,90,96.3,77.1,91.3,96.6
642,36500,"Olympia-Lacey-Tumwater, WA (Metropolitan Statistical Area)",2018,50469,271300,2550,273850,268750,14437014,286056,108.1,106.6,116.4,104.6,116
643,36540,"Omaha-Council Bluffs, NE-IA (Metropolitan Statistical Area)",2018,57374,163400,934,164334,162466,53987434,940970,91.9,94.7,85.4,92.2,98.6
644,36740,"Orlando-Kissimmee-Sanford, FL (Metropolitan Statistical Area)",2018,43717,201600,1434,203034,200166,112563950,2574838,98.6,96.6,107.1,95.2,105.8
645,36780,"Oshkosh-Neenah, WI (Metropolitan Statistical Area)",2018,47974,149500,2313,151813,147187,8197668,170878,89.5,95.4,74.5,91.4,96
646,36980,"Owensboro, KY (Metropolitan Statistical Area)",2018,41075,125500,3138,128638,122362,4882979,118879,87.1,96.4,65,90.5,93.5
647,37100,"Oxnard-Thousand Oaks-Ventura, CA (Metropolitan Statistical Area)",2018,61900,559700,3913,563613,555787,52500391,848142,117.4,101.2,172.4,106.8,126.1
648,37340,"Palm Bay-Melbourne-Titusville, FL (Metropolitan Statistical Area)",2018,45959,177400,2781,180181,174619,27354878,595203,96.1,96.6,96.9,95.1,103.2
649,37460,"Panama City, FL (Metropolitan Statistical Area)",2018,43188,170900,3140,174040,167760,8043321,186240,94.6,96.6,91.2,95.2,101.5
650,37620,"Parkersburg-Vienna, WV (Metropolitan Statistical Area)",2018,43265,116200,3553,119753,112647,3893418,89991,87.7,96.4,62.9,95.1,94.1
651,37860,"Pensacola-Ferry Pass-Brent, FL (Metropolitan Statistical Area)",2018,43471,153600,2048,155648,151552,21492072,494399,92.3,96.6,82.1,95.1,99.1
652,37900,"Peoria, IL (Metropolitan Statistical Area)",2018,48408,135500,1709,137209,133791,19524347,403328,87.8,95.3,68.4,91.4,94.3
653,37980,"Philadelphia-Camden-Wilmington, PA-NJ-DE-MD (Metropolitan Statistical Area)",2018,64228,245000,847,245847,244153,391224070,6091208,105.3,100,109.4,108.5,113
654,38060,"Phoenix-Mesa-Chandler, AZ (Metropolitan Statistical Area)",2018,46539,234300,949,235249,233351,225676984,4849209,98.1,94.3,100.7,100.8,105.4
655,38220,"Pine Bluff, AR (Metropolitan Statistical Area)",2018,34365,82200,2397,84597,79803,3066965,89246,80.8,95.8,49.5,91.3,86.8
656,38300,"Pittsburgh, PA (Metropolitan Statistical Area)",2018,58206,148000,737,148737,147263,135191378,2322653,92.8,98.9,78.9,92.9,99.6
657,38340,"Pittsfield, MA (Metropolitan Statistical Area)",2018,56651,208500,6381,214881,202119,7132374,125901,99,99.1,91.9,103.8,106.3
658,38540,"Pocatello, ID (Metropolitan Statistical Area)",2018,38310,152500,3070,155570,149430,3615429,94374,87.3,97.6,65.2,94,93.7
659,38860,"Portland-South Portland, ME (Metropolitan Statistical Area)",2018,57913,252600,2630,255230,249970,30997140,535232,103.8,99.3,111.5,104.1,111.4
660,38900,"Portland-Vancouver-Hillsboro, OR-WA (Metropolitan Statistical Area)",2018,57903,342900,1358,344258,341542,143214639,2473350,104.5,101.6,124.7,97.6,112.2
661,38940,"Port St. Lucie, FL (Metropolitan Statistical Area)",2018,54373,185100,4444,189544,180656,26162619,481167,97.8,96.6,104,95.2,105
662,39300,"Providence-Warwick, RI-MA (Metropolitan Statistical Area)",2018,54230,266700,1485,268185,265215,87981541,1622379,100.3,99.5,95.5,104.6,107.7
663,39340,"Provo-Orem, UT (Metropolitan Statistical Area)",2018,41212,278200,1917,280117,276283,26093360,633149,95.6,93,96.1,98.9,102.7
664,39380,"Pueblo, CO (Metropolitan Statistical Area)",2018,39293,155400,2175,157575,153225,6578511,167422,89.5,92.9,73,99,96
665,39460,"Punta Gorda, FL (Metropolitan Statistical Area)",2018,41795,176500,3454,179954,173046,7725742,184849,96.2,96.6,97.1,95.2,103.3
666,39540,"Racine, WI (Metropolitan Statistical Area)",2018,49710,169900,2372,172272,167528,9760878,196357,92.3,96.3,81.9,94.1,99.1
667,39580,"Raleigh-Cary, NC (Metropolitan Statistical Area)",2018,56207,236200,1795,237995,234405,76531044,1361590,96.5,96.6,98.7,95.1,103.5
668,39660,"Rapid City, SD (Metropolitan Statistical Area)",2018,50137,181600,3693,185293,177907,7026924,140154,89,94.6,75,92.1,95.6
669,39740,"Reading, PA (Metropolitan Statistical Area)",2018,49439,174200,1553,175753,172647,20790624,420529,95.7,98.9,86.2,97.9,102.7
670,39820,"Redding, CA (Metropolitan Statistical Area)",2018,46589,242500,3782,246282,238718,8372513,179709,97.7,98.1,92,101.6,104.9
671,39900,"Reno, NV (Metropolitan Statistical Area)",2018,61900,298700,2715,301415,295985,28989976,468335,97.6,93,105,98.9,104.8
672,40060,"Richmond, VA (Metropolitan Statistical Area) *",2018,57124,228700,1436,230136,227264,73178594,1281053,96,96.5,96.4,95.1,103
673,40140,"Riverside-San Bernardino-Ontario, CA (Metropolitan Statistical Area)",2018,40382,320400,1255,321655,319145,186261819,4612542,107,98.8,119.5,107.2,114.9
674,40220,"Roanoke, VA (Metropolitan Statistical Area) *",2018,47092,175600,1952,177552,173648,14741327,313033,90.4,96,75,95.1,97.1
675,40340,"Rochester, MN (Metropolitan Statistical Area)",2018,54918,190300,2125,192425,188175,12071724,219814,93.3,94.6,92.7,92.1,100.1
676,40380,"Rochester, NY (Metropolitan Statistical Area)",2018,51115,140800,779,141579,140021,54775889,1071621,97,98.9,91.9,97.9,104.1
677,40420,"Rockford, IL (Metropolitan Statistical Area)",2018,44029,121400,1367,122767,120033,14842571,337110,87.3,95.4,68.9,91.4,93.7
678,40580,"Rocky Mount, NC (Metropolitan Statistical Area)",2018,39917,109200,2609,111809,106591,5831032,146078,84.5,96.6,53.4,95.1,90.7
679,40660,"Rome, GA (Metropolitan Statistical Area)",2018,38382,129600,5681,135281,123919,3760045,97964,83,92.4,58.9,94.8,89.1
680,40900,"Sacramento-Roseville-Folsom, CA (Metropolitan Statistical Area)",2018,56502,365900,1457,367357,364443,132323857,2341940,104.4,98.1,122.6,101.6,112.1
681,40980,"Saginaw, MI (Metropolitan Statistical Area)",2018,39521,97700,1836,99536,95864,7540269,190791,86.8,95.4,65.4,91.4,93.2
682,41060,"St. Cloud, MN (Metropolitan Statistical Area)",2018,46240,173700,1460,175160,172240,9255764,200166,90.7,94.7,80.7,92.2,97.4
683,41100,"St. George, UT (Metropolitan Statistical Area)",2018,40053,262200,5736,267936,256464,6871840,171567,94.3,97.6,89.7,94,101.3
684,41140,"St. Joseph, MO-KS (Metropolitan Statistical Area)",2018,38418,119700,2795,122495,116905,4840654,125998,85.2,94.7,59.7,92.1,91.4
685,41180,"St. Louis, MO-IL (Metropolitan Statistical Area)",2018,55277,167700,704,168404,166996,154995620,2803958,90.7,96.1,81.9,89.7,97.4
686,41420,"Salem, OR (Metropolitan Statistical Area)",2018,43030,229500,2390,231890,227110,18520089,430404,98.5,101.6,94.7,97.6,105.8
687,41500,"Salinas, CA (Metropolitan Statistical Area)",2018,56634,477200,6194,483394,471006,24576499,433950,110.5,98.1,156.2,101.6,118.6
688,41540,"Salisbury, MD-DE (Metropolitan Statistical Area)",2018,48594,226500,2432,228932,224068,19923630,409999,89.1,92.5,78.5,94.9,95.7
689,41620,"Salt Lake City, UT (Metropolitan Statistical Area)",2018,52150,276200,1665,277865,274535,63554301,1218681,98,93.1,107.1,98.8,105.2
690,41660,"San Angelo, TX (Metropolitan Statistical Area)",2018,47875,130900,5505,136405,125395,5784930,120834,91.2,96.4,82.6,91.3,97.9
691,41700,"San Antonio-New Braunfels, TX (Metropolitan Statistical Area)",2018,47349,161400,845,162245,160555,118958647,2512379,93.1,96.3,90.7,91.3,100
692,41740,"San Diego-Chula Vista-Carlsbad, CA (Metropolitan Statistical Area)",2018,61147,526300,2895,529195,523405,203855654,3333861,117.8,100.4,170,109.5,126.5
693,41860,"San Francisco-Oakland-Berkeley, CA (Metropolitan Statistical Area)",2018,100236,781200,3082,784282,778118,473747078,4726314,133.9,114.8,199.5,118.5,143.7
694,41940,"San Jose-Sunnyvale-Santa Clara, CA (Metropolitan Statistical Area)",2018,108565,898300,4124,902424,894176,216457424,1993804,128,109.3,221.4,110.2,137.5
695,42020,"San Luis Obispo-Paso Robles, CA (Metropolitan Statistical Area)",2018,58108,537900,7964,545864,529936,16465164,283354,109.5,98.1,149.2,101.6,117.5
696,42100,"Santa Cruz-Watsonville, CA (Metropolitan Statistical Area)",2018,68277,711000,10832,721832,700168,18697119,273841,124.2,109.5,177,110.4,133.4
697,42140,"Santa Fe, NM (Metropolitan Statistical Area)",2018,58696,282600,4939,287539,277661,8790396,149761,97.1,92.9,102.9,99,104.3
698,42200,"Santa Maria-Santa Barbara, CA (Metropolitan Statistical Area)",2018,63314,549900,15339,565239,534561,28224056,445780,112.1,98.1,171.1,101.6,120.3
699,42220,"Santa Rosa-Petaluma, CA (Metropolitan Statistical Area)",2018,63397,568700,6082,574782,562618,31612355,498643,121.2,109.5,160,110.4,130.1
700,42340,"Savannah, GA (Metropolitan Statistical Area)",2018,47038,178700,3839,182539,174861,18319186,389453,94.2,96.6,88.8,95.1,101.1
701,42540,"Scranton--Wilkes-Barre, PA (Metropolitan Statistical Area)",2018,45993,137300,1697,138997,135603,25535827,555215,91.4,98.9,70.4,97.9,98.2
702,42660,"Seattle-Tacoma-Bellevue, WA (Metropolitan Statistical Area)",2018,74815,397000,1377,398377,395623,294409674,3935179,113.6,108.2,143.9,104.5,122
703,42680,"Sebastian-Vero Beach, FL (Metropolitan Statistical Area)",2018,79353,185800,4885,190685,180915,12473322,157187,93,92.5,91.5,94.9,99.8
704,42700,"Sebring-Avon Park, FL (Metropolitan Statistical Area)",2018,33548,93800,4168,97968,89632,3520298,104933,85.9,92.5,70.1,94.9,92.2
705,43100,"Sheboygan, WI (Metropolitan Statistical Area)",2018,53263,153700,2678,156378,151022,6137617,115233,88.5,95.4,71.2,91.4,95
706,43300,"Sherman-Denison, TX (Metropolitan Statistical Area)",2018,42480,125000,4362,129362,120638,5683293,133787,90.5,96.5,79.4,91.3,97.2
707,43340,"Shreveport-Bossier City, LA (Metropolitan Statistical Area)",2018,47002,144500,3313,147813,141187,18672868,397281,87.5,96.3,70.3,91.3,93.9
708,43420,"Sierra Vista-Douglas, AZ (Metropolitan Statistical Area)",2018,39911,143800,3455,147255,140345,5045137,126411,88.5,97.6,71.2,94,95
709,43580,"Sioux City, IA-NE-SD (Metropolitan Statistical Area)",2018,51212,125200,2948,128148,122252,7363690,143787,88.5,94.6,70,92.1,95
710,43620,"Sioux Falls, SD (Metropolitan Statistical Area)",2018,60237,179500,2267,181767,177233,15891144,263810,91.1,94.7,82.2,92.2,97.8
711,43780,"South Bend-Mishawaka, IN-MI (Metropolitan Statistical Area)",2018,47300,125600,1939,127539,123661,15263634,322697,87.8,95.3,70.2,91.3,94.3
712,43900,"Spartanburg, SC (Metropolitan Statistical Area)",2018,43055,127800,2212,130012,125588,13525267,314137,89.4,96.6,69.1,95.1,95.9
713,44060,"Spokane-Spokane Valley, WA (Metropolitan Statistical Area)",2018,46304,207000,2089,209089,204911,25876063,558827,96.5,98.7,85.9,101.1,103.6
714,44100,"Springfield, IL (Metropolitan Statistical Area)",2018,47955,138100,2267,140367,135833,9971208,207928,89.7,95.4,74.3,91.4,96.3
715,44140,"Springfield, MA (Metropolitan Statistical Area)",2018,52317,222600,1847,224447,220753,36629063,700138,97.9,99.1,88.1,103.8,105.1
716,44180,"Springfield, MO (Metropolitan Statistical Area)",2018,41243,142200,1451,143651,140749,19230402,466273,86.2,94.7,65.2,92.2,92.5
717,44220,"Springfield, OH (Metropolitan Statistical Area)",2018,40563,111600,2022,113622,109578,5456881,134528,85.4,95.4,60.9,91.4,91.6
718,44300,"State College, PA (Metropolitan Statistical Area)",2018,45866,220500,3966,224466,216534,7457920,162601,100.8,98.9,109.3,97.9,108.2
719,44420,"Staunton, VA (Metropolitan Statistical Area) *",2018,44336,194200,3949,198149,190251,5436837,122628,86.2,92.5,70.5,94.9,92.6
720,44700,"Stockton, CA (Metropolitan Statistical Area)",2018,44697,313800,3895,317695,309905,33634157,752491,101.4,98.1,107.4,101.6,108.9
721,44940,"Sumter, SC (Metropolitan Statistical Area)",2018,37335,113900,4932,118832,108968,5232598,140151,85.3,94.6,57.8,95.1,91.6
722,45060,"Syracuse, NY (Metropolitan Statistical Area)",2018,49954,134000,1029,135029,132971,32483834,650281,95.9,98.9,87,97.9,102.9
723,45220,"Tallahassee, FL (Metropolitan Statistical Area)",2018,43009,172300,2323,174623,169977,16529184,384318,93.2,96.2,85.5,95.1,100.1
724,45300,"Tampa-St. Petersburg-Clearwater, FL (Metropolitan Statistical Area)",2018,47332,175600,1110,176710,174490,149314487,3154649,98.3,92.7,105.1,100.7,105.5
725,45460,"Terre Haute, IN (Metropolitan Statistical Area)",2018,37600,90200,2459,92659,87741,7020899,186726,86.1,95.2,62.3,91.3,92.5
726,45500,"Texarkana, TX-AR (Metropolitan Statistical Area)",2018,37747,106100,3533,109633,102567,5637393,149347,85.5,95.6,60.6,91.4,91.8
727,45540,"The Villages, FL (Metropolitan Statistical Area)",2018,47364,246500,5125,251625,241375,6096685,128719,94.3,92.5,95.4,95,101.2
728,45780,"Toledo, OH (Metropolitan Statistical Area)",2018,46919,124400,1513,125913,122887,30173121,643089,86.6,95.3,64.9,91.4,92.9
729,45820,"Topeka, KS (Metropolitan Statistical Area)",2018,46229,130700,1967,132667,128733,10737323,232266,88.4,94.6,71.2,92.1,94.9
730,45940,"Trenton-Princeton, NJ (Metropolitan Statistical Area)",2018,69080,284200,4289,288489,279911,25434539,368188,106.5,100.3,119.8,106,114.3
731,46060,"Tucson, AZ (Metropolitan Statistical Area)",2018,44015,173500,1257,174757,172243,45623879,1036554,93.3,92.9,86.5,99,100.1
732,46140,"Tulsa, OK (Metropolitan Statistical Area)",2018,54875,144300,798,145098,143502,54497793,993135,88.8,96.4,72.9,91.3,95.4
733,46220,"Tuscaloosa, AL (Metropolitan Statistical Area)",2018,38429,157400,2372,159772,155028,9655490,251257,86.5,95.9,65.6,90.6,92.9
734,46300,"Twin Falls, ID (Metropolitan Statistical Area)",2018,39937,159400,3393,162793,156007,4396837,110095,89.5,97.6,72.4,94,96.1
735,46340,"Tyler, TX (Metropolitan Statistical Area)",2018,55281,153500,2457,155957,151043,12700793,229749,91.9,96.5,84.9,91.3,98.6
736,46520,"Urban Honolulu, HI (Metropolitan Statistical Area)",2018,59324,649800,3731,653531,646069,58129300,979858,123.8,114.9,171.6,105.7,132.9
737,46540,"Utica-Rome, NY (Metropolitan Statistical Area)",2018,43984,117800,1829,119629,115971,12807674,291187,92.6,98.9,74.4,97.9,99.4
738,46660,"Valdosta, GA (Metropolitan Statistical Area)",2018,36438,125200,3859,129059,121341,5325097,146143,83.5,92.5,63.1,94.8,89.7
739,46700,"Vallejo, CA (Metropolitan Statistical Area)",2018,50756,377500,2862,380362,374638,22623154,445725,118.3,109.5,143.7,110.4,127
740,47020,"Victoria, TX (Metropolitan Statistical Area)",2018,46748,136500,5185,141685,131315,4649847,99466,92.2,96.3,86.1,91.3,98.9
741,47220,"Vineland-Bridgeton, NJ (Metropolitan Statistical Area)",2018,39587,162500,2392,164892,160108,5963194,150635,97.1,100.5,86.8,100.6,104.3
742,47260,"Virginia Beach-Norfolk-Newport News, VA-NC (Metropolitan Statistical Area) *",2018,50355,242100,1175,243275,240925,88811777,1763713,96.9,96.4,100.3,95.2,104
743,47300,"Visalia, CA (Metropolitan Statistical Area)",2018,40206,191200,2841,194041,188359,18679327,464589,94.8,98.1,80.8,101.6,101.8
744,47380,"Waco, TX (Metropolitan Statistical Area)",2018,40990,128700,3180,131880,125520,11125844,271427,89,96.1,74.8,91.4,95.6
745,47460,"Walla Walla, WA (Metropolitan Statistical Area)",2018,46429,207200,6850,214050,200350,2814320,60615,97.6,102.9,88.9,97.5,104.8
746,47580,"Warner Robins, GA (Metropolitan Statistical Area)",2018,41896,136500,3086,139586,133414,7662276,182886,89,96.6,69.3,95.1,95.5
747,47900,"Washington-Arlington-Alexandria, DC-VA-MD-WV (Metropolitan Statistical Area) *",2018,72340,411500,1334,412834,410166,451967783,6247841,116.9,103.9,162.4,107.3,125.5
748,47940,"Waterloo-Cedar Falls, IA (Metropolitan Statistical Area)",2018,46499,145600,2287,147887,143313,7855415,168936,89.5,94.6,75.6,92.1,96.1
749,48060,"Watertown-Fort Drum, NY (Metropolitan Statistical Area)",2018,46800,149500,4085,153585,145415,5235284,111866,97.6,98.9,95.4,97.9,104.8
750,48140,"Wausau-Weston, WI (Metropolitan Statistical Area)",2018,49684,152000,2237,154237,149763,8103082,163094,88.9,95.3,71.6,91.3,95.4
751,48260,"Weirton-Steubenville, WV-OH (Metropolitan Statistical Area)",2018,40634,91000,1856,92856,89144,4753425,116982,83.9,94.5,51.9,93.3,90.1
752,48300,"Wenatchee, WA (Metropolitan Statistical Area)",2018,49575,264700,6012,270712,258688,5924225,119501,100.2,102.9,99.2,97.5,107.6
753,48540,"Wheeling, WV-OH (Metropolitan Statistical Area)",2018,49171,105500,2527,108027,102973,6886865,140059,84.9,96.6,54.3,95.1,91.1
754,48620,"Wichita, KS (Metropolitan Statistical Area)",2018,50391,133700,1180,134880,132520,32125008,637519,88.4,94.7,71,92.2,94.9
755,48660,"Wichita Falls, TX (Metropolitan Statistical Area)",2018,43256,97300,2289,99589,95011,6529713,150955,86.9,96.3,68.6,91.3,93.3
756,48700,"Williamsport, PA (Metropolitan Statistical Area)",2018,43571,152400,2453,154853,149947,4961200,113866,91.6,98.9,72.1,97.9,98.4
757,48900,"Wilmington, NC (Metropolitan Statistical Area)",2018,44618,222700,3460,226160,219240,13129781,294273,93.5,96,87.5,95.1,100.4
758,49020,"Winchester, VA-WV (Metropolitan Statistical Area) *",2018,48100,224900,4297,229197,220603,6709592,139492,93.2,92.5,92,94.8,100
759,49180,"Winston-Salem, NC (Metropolitan Statistical Area)",2018,44502,147600,1648,149248,145952,29866780,671129,88.6,96.6,66.9,95.1,95.2
760,49340,"Worcester, MA-CT (Metropolitan Statistical Area)",2018,55181,259300,1938,261238,257362,52207397,946113,103.4,101,100.6,107.7,111
761,49420,"Yakima, WA (Metropolitan Statistical Area)",2018,43905,167700,2764,170464,164936,11001031,250562,94.1,98.1,76.9,101.6,101.1
762,49620,"York-Hanover, PA (Metropolitan Statistical Area)",2018,49888,173200,1289,174489,171911,22342240,447847,95.8,98.9,86.8,97.9,102.9
763,49660,"Youngstown-Warren-Boardman, OH-PA (Metropolitan Statistical Area)",2018,42255,106300,1105,107405,105195,22742602,538226,85.8,95.8,59.8,93,92.1
764,49700,"Yuba City, CA (Metropolitan Statistical Area)",2018,43662,249000,6495,255495,242505,7593081,173905,97.1,98.1,89.7,101.6,104.2
765,49740,"Yuma, AZ (Metropolitan Statistical Area) *",2018,35012,122000,2288,124288,119712,7408956,211612,88.3,92.9,70.2,99,94.8
766,10180,"Abilene, TX (Metropolitan Statistical Area)",2017,40876,102000,2634,104634,99366,6966419,170429,89.8,96,96,91.3,94.6
767,10420,"Akron, OH (Metropolitan Statistical Area)",2017,47522,140800,1409,142209,139391,33455069,703987,90.5,95.8,95.8,92.1,95.2
768,10500,"Albany, GA (Metropolitan Statistical Area)",2017,36780,111700,3130,114830,108570,5446810,148090,82.9,96,96,95.1,87.2
769,10540,"Albany-Lebanon, OR (Metropolitan Statistical Area)",2017,41169,184900,4443,189343,180457,5147507,125035,97,103.1,103.1,97.2,102.1
770,10580,"Albany-Schenectady-Troy, NY (Metropolitan Statistical Area)",2017,56487,203300,1705,205005,201595,49830518,882158,99.4,98.9,98.9,97.9,104.7
771,10740,"Albuquerque, NM (Metropolitan Statistical Area) *",2017,40912,181300,1427,182727,179873,37324817,912311,93.9,93,93,98.6,98.9
772,10780,"Alexandria, LA (Metropolitan Statistical Area)",2017,41032,128700,4161,132861,124539,6300415,153549,86.5,96.2,96.2,91.4,91
773,10900,"Allentown-Bethlehem-Easton, PA-NJ (Metropolitan Statistical Area)",2017,51411,202800,1657,204457,201143,43078169,837921,99,99.1,99.1,99.2,104.2
774,11020,"Altoona, PA (Metropolitan Statistical Area)",2017,44330,117300,2559,119859,114741,5459082,123147,89.7,98.9,98.9,98,94.4
775,11100,"Amarillo, TX (Metropolitan Statistical Area)",2017,44608,129900,2378,132278,127522,11791320,264331,91.9,96.4,96.4,91.4,96.7
776,11180,"Ames, IA (Metropolitan Statistical Area)",2017,41375,172900,3657,176557,169243,5118925,123721,92,94,94,91.5,96.9
777,11260,"Anchorage, AK (Metropolitan Statistical Area)",2017,58732,284300,2935,287235,281365,23526077,400570,108.6,102.1,102.1,100.4,114.3
778,11460,"Ann Arbor, MI (Metropolitan Statistical Area)",2017,56312,231500,3045,234545,228455,20768333,368807,100.2,97.7,97.7,95.9,105.5
779,11500,"Anniston-Oxford, AL (Metropolitan Statistical Area)",2017,35927,110100,3241,113341,106859,4121206,114710,83.3,96.7,96.7,90.6,87.6
780,11540,"Appleton, WI (Metropolitan Statistical Area)",2017,49188,161800,1529,163329,160271,11598983,235811,89.8,95.4,95.4,91.5,94.6
781,11700,"Asheville, NC (Metropolitan Statistical Area)",2017,43474,198100,3144,201244,194956,19774194,454855,92.8,95.3,95.3,95,97.7
782,12020,"Athens-Clarke County, GA (Metropolitan Statistical Area)",2017,39025,162600,2671,165271,159929,8160419,209106,91.2,96.4,96.4,95.1,96
783,12060,"Atlanta-Sandy Springs-Alpharetta, GA (Metropolitan Statistical Area)",2017,50680,184200,1042,185242,183158,297613678,5872432,97.3,98,98,98.1,102.4
784,12100,"Atlantic City-Hammonton, NJ (Metropolitan Statistical Area)",2017,46796,219000,2698,221698,216302,12424234,265498,99.2,100.5,100.5,100.8,104.4
785,12220,"Auburn-Opelika, AL (Metropolitan Statistical Area)",2017,36845,157100,4206,161306,152894,5948184,161440,83.7,92.5,92.5,89.9,88.1
786,12260,"Augusta-Richmond County, GA-SC (Metropolitan Statistical Area)",2017,40646,133500,2002,135502,131498,24398910,600276,88.6,96.2,96.2,95.1,93.3
787,12420,"Austin-Round Rock-Georgetown, TX (Metropolitan Statistical Area)",2017,56087,240500,1555,242055,238945,118651329,2115475,99,96.5,96.5,91.4,104.2
788,12540,"Bakersfield, CA (Metropolitan Statistical Area)",2017,38388,190600,2222,192822,188378,34063749,887356,97.3,98.2,98.2,101.2,102.4
789,12580,"Baltimore-Columbia-Towson, MD (Metropolitan Statistical Area)",2017,59774,285700,1371,287071,284329,167288930,2798707,106.3,102,102,104.4,111.9
790,12620,"Bangor, ME (Metropolitan Statistical Area)",2017,39791,137900,2832,140732,135068,6034142,151645,97.4,99.1,99.1,103.8,102.5
791,12700,"Barnstable Town, MA (Metropolitan Statistical Area)",2017,71080,375000,3721,378721,371279,15181333,213581,105.9,99.1,99.1,103.8,111.4
792,12940,"Baton Rouge, LA (Metropolitan Statistical Area)",2017,45853,168200,1449,169649,166751,39172207,854295,91.3,95.6,95.6,91.3,96
793,12980,"Battle Creek, MI (Metropolitan Statistical Area)",2017,38408,102600,2823,105423,99777,5153616,134180,88.3,95.4,95.4,91.5,93
794,13020,"Bay City, MI (Metropolitan Statistical Area)",2017,40130,96800,2697,99497,94103,4175285,104045,85.4,95.4,95.4,91.5,89.9
795,13140,"Beaumont-Port Arthur, TX (Metropolitan Statistical Area)",2017,42747,102900,2288,105188,100612,17018856,398129,88.4,96.5,96.5,91.4,93.1
796,13220,"Beckley, WV (Metropolitan Statistical Area)",2017,36847,96700,4486,101186,92214,4372759,118673,76,92.5,92.5,94.6,80
797,13380,"Bellingham, WA (Metropolitan Statistical Area)",2017,46452,299800,5614,305414,294186,10284959,221410,100.1,98.2,98.2,101.2,105.3
798,13460,"Bend, OR (Metropolitan Statistical Area)",2017,52547,298200,7234,305434,290966,9812799,186744,102.8,103.1,103.1,97.2,108.1
799,13740,"Billings, MT (Metropolitan Statistical Area)",2017,50482,211200,3129,214329,208071,9054678,179365,95.3,93.7,93.7,98,100.3
800,13780,"Binghamton, NY (Metropolitan Statistical Area)",2017,43300,113100,1501,114601,111599,10466036,241709,95.3,98.9,98.9,97.9,100.3
801,13820,"Birmingham-Hoover, AL (Metropolitan Statistical Area)",2017,49321,152200,1370,153570,150830,53543159,1085615,87.7,96.5,96.5,90.6,92.3
802,13900,"Bismarck, ND (Metropolitan Statistical Area)",2017,54526,223600,3609,227209,219991,6985640,128115,93.3,94.8,94.8,92.3,98.2
803,13980,"Blacksburg-Christiansburg, VA (Metropolitan Statistical Area) *",2017,36811,168700,3264,171964,165436,6132976,166605,88.8,92.5,92.5,94.7,93.5
804,14010,"Bloomington, IL (Metropolitan Statistical Area)",2017,47438,158700,1653,160353,157047,8195140,172754,92.3,95.4,95.4,91.5,97.2
805,14020,"Bloomington, IN (Metropolitan Statistical Area)",2017,40147,155300,2461,157761,152839,6721779,167429,91.9,95.3,95.3,91.4,96.8
806,14100,"Bloomsburg-Berwick, PA (Metropolitan Statistical Area)",2017,43953,151100,3179,154279,147921,3685496,83851,92.9,98.9,98.9,97.9,97.8
807,14260,"Boise City, ID (Metropolitan Statistical Area)",2017,44225,192600,2082,194682,190518,31385382,709682,92.4,93.2,93.2,98.5,97.2
808,14460,"Boston-Cambridge-Newton, MA-NH (Metropolitan Statistical Area)",2017,75012,393500,1119,394619,392381,363192458,4841772,114,103.7,103.7,111.1,120
809,14500,"Boulder, CO (Metropolitan Statistical Area) *",2017,69968,423500,6583,430083,416917,22560576,322441,106.6,96.5,96.5,97.1,112.2
810,14540,"Bowling Green, KY (Metropolitan Statistical Area)",2017,35669,134200,3645,137845,130555,6241402,174981,84.6,92.2,92.2,90.2,89
811,14740,"Bremerton-Silverdale-Port Orchard, WA (Metropolitan Statistical Area)",2017,52819,277500,3309,280809,274191,14065097,266289,107.2,106.6,106.6,104.5,112.8
812,14860,"Bridgeport-Stamford-Norwalk, CT (Metropolitan Statistical Area)",2017,111380,417800,4822,422622,412978,105035532,943038,113.9,105.6,105.6,108.6,119.9
813,15180,"Brownsville-Harlingen, TX (Metropolitan Statistical Area)",2017,27622,82500,1220,83720,81280,11662651,422227,82.4,96.5,96.5,91.4,86.7
814,15260,"Brunswick, GA (Metropolitan Statistical Area)",2017,39545,136300,5832,142132,130468,4649984,117587,87,92.5,92.5,94.7,91.6
815,15380,"Buffalo-Cheektowaga, NY (Metropolitan Statistical Area)",2017,48942,135000,1013,136013,133987,55298925,1129882,93.9,98.9,98.9,98,98.9
816,15500,"Burlington, NC (Metropolitan Statistical Area)",2017,38508,145500,3245,148745,142255,6287496,163276,89.2,96.6,96.6,95.1,93.9
817,15540,"Burlington-South Burlington, VT (Metropolitan Statistical Area)",2017,55172,261700,3025,264725,258675,12081200,218975,106.3,99.1,99.1,103.8,111.9
818,15680,"California-Lexington Park, MD (Metropolitan Statistical Area)",2017,54546,291500,5774,297274,285726,6135724,112487,99.6,92.5,92.5,94.7,104.8
819,15940,"Canton-Massillon, OH (Metropolitan Statistical Area)",2017,43025,126300,1628,127928,124672,17180907,399327,86.8,95.4,95.4,91.5,91.3
820,15980,"Cape Coral-Fort Myers, FL (Metropolitan Statistical Area)",2017,49714,190200,2576,192776,187624,36788238,740000,96.7,96.6,96.6,95.1,101.8
821,16020,"Cape Girardeau, MO-IL (Metropolitan Statistical Area)",2017,41638,139300,4088,143388,135212,4031349,96819,83.3,94,94,91.5,87.7
822,16060,"Carbondale-Marion, IL (Metropolitan Statistical Area)",2017,39110,107300,3646,110946,103654,5371869,137352,83.6,94.7,94.7,90.8,88
823,16180,"Carson City, NV (Metropolitan Statistical Area)",2017,48572,217400,6822,224222,210578,2648726,54532,95.3,97.7,97.7,94,100.3
824,16220,"Casper, WY (Metropolitan Statistical Area)",2017,62752,198600,4582,203182,194018,4994150,79586,94.4,93,93,98.7,99.4
825,16300,"Cedar Rapids, IA (Metropolitan Statistical Area)",2017,50096,149400,1655,151055,147745,13558514,270653,88.8,94.8,94.8,92.2,93.4
826,16540,"Chambersburg-Waynesboro, PA (Metropolitan Statistical Area)",2017,44264,175800,3256,179056,172544,6833358,154376,93.7,98.9,98.9,97.9,98.7
827,16580,"Champaign-Urbana, IL (Metropolitan Statistical Area)",2017,44169,148600,2308,150908,146292,10019675,226847,92.9,95.3,95.3,91.4,97.8
828,16620,"Charleston, WV (Metropolitan Statistical Area)",2017,41587,105100,2174,107274,102926,10988466,264227,86.3,95.2,95.2,95.1,90.8
829,16700,"Charleston-North Charleston, SC (Metropolitan Statistical Area)",2017,48921,207500,3036,210536,204464,37940075,775537,96.1,96.6,96.6,95.1,101.2
830,16740,"Charlotte-Concord-Gastonia, NC-SC (Metropolitan Statistical Area)",2017,50300,177000,1086,178086,175914,128282947,2550373,93.7,96.2,96.2,95.1,98.6
831,16820,"Charlottesville, VA (Metropolitan Statistical Area) *",2017,64000,267800,4071,271871,263729,13830689,216104,98.8,96.4,96.4,95.1,104
832,16860,"Chattanooga, TN-GA (Metropolitan Statistical Area)",2017,44455,152600,1516,154116,151084,24714999,555953,87.8,96.5,96.5,90.6,92.4
833,16940,"Cheyenne, WY (Metropolitan Statistical Area)",2017,49695,202800,4640,207440,198160,4888842,98377,95,93,93,98.7,100
834,16980,"Chicago-Naperville-Elgin, IL-IN-WI (Metropolitan Statistical Area)",2017,58331,222600,636,223236,221964,554968158,9514113,102.9,100.3,100.3,100.2,108.3
835,17020,"Chico, CA (Metropolitan Statistical Area)",2017,43164,238200,3917,242117,234283,9871490,228696,100,98.2,98.2,101.2,105.3
836,17140,"Cincinnati, OH-KY-IN (Metropolitan Statistical Area)",2017,51844,158800,791,159591,158009,114189768,2202558,90.8,96.1,96.1,92.5,95.5
837,17300,"Clarksville, TN-KY (Metropolitan Statistical Area)",2017,39834,144300,2354,146654,141946,11895962,298635,88.4,96.4,96.4,90.6,93.1
838,17420,"Cleveland, TN (Metropolitan Statistical Area)",2017,37318,146100,3888,149988,142212,4559534,122180,82.6,92.5,92.5,89.9,87
839,17460,"Cleveland-Elyria, OH (Metropolitan Statistical Area)",2017,51608,142400,826,143226,141574,106170433,2057238,90.3,95.8,95.8,92.1,95.1
840,17660,"Coeur d'Alene, ID (Metropolitan Statistical Area)",2017,43304,212900,6944,219844,205956,6812591,157320,93.6,97.7,97.7,94,98.6
841,17780,"College Station-Bryan, TX (Metropolitan Statistical Area)",2017,37837,159300,3272,162572,156028,9804510,259123,92,96.1,96.1,91.4,96.8
842,17820,"Colorado Springs, CO (Metropolitan Statistical Area)",2017,47098,239100,1806,240906,237294,34135433,724773,97.7,93.1,93.1,98.5,102.8
843,17860,"Columbia, MO (Metropolitan Statistical Area)",2017,44749,177800,4015,181815,173785,9205990,205725,89.4,94.8,94.8,92.3,94.1
844,17900,"Columbia, SC (Metropolitan Statistical Area)",2017,43808,145900,1288,147188,144612,36139195,824939,91.7,96.2,96.2,95.1,96.5
845,17980,"Columbus, GA-AL (Metropolitan Statistical Area)",2017,39715,140800,3159,143959,137641,12547542,315942,89,96.2,96.2,95.1,93.6
846,18020,"Columbus, IN (Metropolitan Statistical Area)",2017,48154,139400,3957,143357,135443,3958850,82213,89.1,94.7,94.7,90.7,93.7
847,18140,"Columbus, OH (Metropolitan Statistical Area)",2017,49441,166600,749,167349,165851,102964961,2082581,91.7,95.3,95.3,91.4,96.6
848,18580,"Corpus Christi, TX (Metropolitan Statistical Area)",2017,42501,121600,2345,123945,119255,18209181,428445,92.6,96.5,96.5,91.4,97.4
849,18700,"Corvallis, OR (Metropolitan Statistical Area)",2017,44685,288700,6026,294726,282674,4101636,91790,103.2,103.1,103.1,97.2,108.6
850,18880,"Crestview-Fort Walton Beach-Destin, FL (Metropolitan Statistical Area)",2017,50459,199500,4077,203577,195423,13699438,271499,94.5,94.4,94.4,95.1,99.5
851,19060,"Cumberland, MD-WV (Metropolitan Statistical Area)",2017,38566,122400,3575,125975,118825,3801626,98575,86.5,96.6,96.6,95.1,91
852,19100,"Dallas-Fort Worth-Arlington, TX (Metropolitan Statistical Area)",2017,53870,174500,541,175041,173959,395250806,7337097,100.2,99,99,98.3,105.4
853,19140,"Dalton, GA (Metropolitan Statistical Area)",2017,34860,116300,3959,120259,112341,5021121,144037,84.1,92.5,92.5,94.6,88.5
854,19180,"Danville, IL (Metropolitan Statistical Area)",2017,37812,75900,1907,77807,73993,2937597,77689,79.7,94.7,94.7,90.7,83.9
855,19300,"Daphne-Fairhope-Foley, AL (Metropolitan Statistical Area)",2017,44566,182000,3992,185992,178008,9471242,212521,89.4,96.6,96.6,90.6,94.1
856,19340,"Davenport-Moline-Rock Island, IA-IL (Metropolitan Statistical Area)",2017,47602,129500,1722,131222,127778,18141237,381103,88.6,94.8,94.8,92.3,93.2
857,19460,"Decatur, AL (Metropolitan Statistical Area)",2017,37366,121000,3455,124455,117545,5678969,151981,81.7,96.7,96.7,90.6,86
858,19500,"Decatur, IL (Metropolitan Statistical Area)",2017,45767,95900,2372,98272,93528,4823759,105399,84.7,95.4,95.4,91.5,89.2
859,19660,"Deltona-Daytona Beach-Ormond Beach, FL (Metropolitan Statistical Area)",2017,41629,156900,1589,158489,155311,26970079,647867,95.2,96.6,96.6,95.1,100.2
860,19740,"Denver-Aurora-Lakewood, CO (Metropolitan Statistical Area) *",2017,60812,317100,1524,318624,315576,175853476,2891776,104.7,98.2,98.2,96.2,110.2
861,19780,"Des Moines-West Des Moines, IA (Metropolitan Statistical Area)",2017,52159,169400,1182,170582,168218,35542100,681413,92.7,94.8,94.8,92.2,97.6
862,19820,"Detroit-Warren-Dearborn, MI (Metropolitan Statistical Area)",2017,50397,149900,619,150519,149281,217795006,4321593,95.2,97.8,97.8,97.8,100.2
863,20020,"Dothan, AL (Metropolitan Statistical Area)",2017,40040,117000,2582,119582,114418,5921045,147878,82.8,95.8,95.8,90.5,87.1
864,20100,"Dover, DE (Metropolitan Statistical Area)",2017,40653,205800,3529,209329,202271,7175296,176499,93.2,96.6,96.6,95.1,98.1
865,20220,"Dubuque, IA (Metropolitan Statistical Area)",2017,46620,157200,2835,160035,154365,4525257,97066,89.9,94.8,94.8,92.3,94.6
866,20260,"Duluth, MN-WI (Metropolitan Statistical Area)",2017,43876,148500,1481,149981,147019,12684906,289108,89.1,94.8,94.8,92.2,93.8
867,20500,"Durham-Chapel Hill, NC (Metropolitan Statistical Area)",2017,51347,212400,3035,215435,209365,32126449,625678,94.5,95.7,95.7,95.1,99.4
868,20700,"East Stroudsburg, PA (Metropolitan Statistical Area)",2017,40507,167200,2808,170008,164392,6801000,167895,96,98.9,98.9,97.9,101
869,20740,"Eau Claire, WI (Metropolitan Statistical Area)",2017,45163,155600,2174,157774,153426,7557155,167329,89.5,95.4,95.4,91.5,94.2
870,20940,"El Centro, CA (Metropolitan Statistical Area)",2017,37060,167700,3108,170808,164592,6731955,181649,91.4,103.1,103.1,97.2,96.2
871,21060,"Elizabethtown-Fort Knox, KY (Metropolitan Statistical Area)",2017,40724,142800,3069,145869,139731,6124409,150390,84.6,92.5,92.5,89.9,89
872,21140,"Elkhart-Goshen, IN (Metropolitan Statistical Area)",2017,45343,130800,2813,133613,127987,9258826,204194,88.8,95.4,95.4,91.5,93.5
873,21300,"Elmira, NY (Metropolitan Statistical Area)",2017,42869,105500,3515,109015,101985,3632530,84736,94.6,98.9,98.9,97.9,99.6
874,21340,"El Paso, TX (Metropolitan Statistical Area)",2017,34595,116300,975,117275,115325,29129580,842005,87.9,96.5,96.5,91.4,92.5
875,21420,"Enid, OK (Metropolitan Statistical Area)",2017,42638,104000,5096,109096,98904,2626515,61600,89.2,96.5,96.5,91.4,93.9
876,21500,"Erie, PA (Metropolitan Statistical Area)",2017,42524,124100,1870,125970,122230,11632868,273558,91.8,98.9,98.9,97.9,96.6
877,21660,"Eugene-Springfield, OR (Metropolitan Statistical Area)",2017,44416,232800,2334,235134,230466,16667640,375264,99.1,98.2,98.2,101.2,104.3
878,21780,"Evansville, IN-KY (Metropolitan Statistical Area)",2017,45480,131400,1904,133304,129496,14316699,314791,88.3,95.4,95.4,91.5,92.9
879,21820,"Fairbanks, AK (Metropolitan Statistical Area) *",2017,54612,230600,6832,237432,223768,5443462,99675,109.1,101.2,101.2,98.3,114.8
880,22020,"Fargo, ND-MN (Metropolitan Statistical Area)",2017,50834,190300,2780,193080,187520,12276915,241511,91.1,94.8,94.8,92.3,95.8
881,22140,"Farmington, NM (Metropolitan Statistical Area)",2017,34006,143300,4626,147926,138674,4315894,126917,90.1,97.7,97.7,94,94.8
882,22180,"Fayetteville, NC (Metropolitan Statistical Area)",2017,35614,132300,2229,134529,130071,18430980,517527,88.4,95.4,95.4,95.1,93.1
883,22220,"Fayetteville-Springdale-Rogers, AR (Metropolitan Statistical Area)",2017,62313,158800,1713,160513,157087,32129787,515616,88.4,96.5,96.5,91.4,93.1
884,22380,"Flagstaff, AZ (Metropolitan Statistical Area)",2017,46824,241400,9243,250643,232157,6602169,141001,98,97.7,97.7,94,103.1
885,22420,"Flint, MI (Metropolitan Statistical Area)",2017,39198,96500,1464,97964,95036,15972759,407488,89.1,97.7,97.7,95.9,93.8
886,22500,"Florence, SC (Metropolitan Statistical Area)",2017,38711,112600,2822,115422,109778,7954201,205476,86.3,95.6,95.6,95.1,90.9
887,22520,"Florence-Muscle Shoals, AL (Metropolitan Statistical Area)",2017,36567,120400,2659,123059,117741,5384883,147259,82.5,96.7,96.7,90.6,86.8
888,22540,"Fond du Lac, WI (Metropolitan Statistical Area)",2017,46055,149400,2500,151900,146900,4716776,102417,87.3,94.7,94.7,90.7,91.9
889,22660,"Fort Collins, CO (Metropolitan Statistical Area)",2017,51748,306600,4381,310981,302219,17805751,344084,100.3,93,93,98.7,105.6
890,22900,"Fort Smith, AR-OK (Metropolitan Statistical Area)",2017,36381,107000,2051,109051,104949,9103592,250231,83.5,96.3,96.3,91.4,87.9
891,23060,"Fort Wayne, IN (Metropolitan Statistical Area)",2017,44238,120500,1257,121757,119243,17936189,405445,88.7,95.4,95.4,91.5,93.4
892,23420,"Fresno, CA (Metropolitan Statistical Area)",2017,41905,220600,2197,222797,218403,41286010,985238,97,98.2,98.2,101.2,102.1
893,23460,"Gadsden, AL (Metropolitan Statistical Area)",2017,36064,105100,3137,108237,101963,3714857,103007,81.1,96.7,96.7,90.6,85.4
894,23540,"Gainesville, FL (Metropolitan Statistical Area)",2017,41438,162000,3024,165024,158976,13445858,324485,93.4,95.4,95.4,95.1,98.3
895,23580,"Gainesville, GA (Metropolitan Statistical Area)",2017,42239,171900,2729,174629,169171,8403625,198953,89.4,92.5,92.5,94.6,94.1
896,23900,"Gettysburg, PA (Metropolitan Statistical Area)",2017,46786,197400,3490,200890,193910,4798471,102562,95.2,98.9,98.9,97.9,100.2
897,24020,"Glens Falls, NY (Metropolitan Statistical Area)",2017,45031,166800,3055,169855,163745,5670429,125924,96.2,98.9,98.9,97.9,101.2
898,24140,"Goldsboro, NC (Metropolitan Statistical Area)",2017,37361,117000,4380,121380,112620,4596723,123034,86.7,96.6,96.6,95.1,91.3
899,24220,"Grand Forks, ND-MN (Metropolitan Statistical Area)",2017,48184,170200,3072,173272,167128,4920789,102126,90.5,94.8,94.8,92.3,95.3
900,24260,"Grand Island, NE (Metropolitan Statistical Area)",2017,42734,130400,4227,134627,126173,3224550,75456,84.8,94,94,91.5,89.2
901,24300,"Grand Junction, CO (Metropolitan Statistical Area)",2017,42972,207900,4135,212035,203765,6496022,151170,93.1,97.7,97.7,94,98
902,24340,"Grand Rapids-Kentwood, MI (Metropolitan Statistical Area)",2017,47501,154700,1037,155737,153663,50525630,1063670,92.2,95.3,95.3,91.4,97
903,24420,"Grants Pass, OR (Metropolitan Statistical Area)",2017,39566,235600,6555,242155,229045,3425747,86584,94.7,103.1,103.1,97.2,99.7
904,24500,"Great Falls, MT (Metropolitan Statistical Area)",2017,46031,168100,2453,170553,165647,3757683,81633,91.4,93,93,98.7,96.1
905,24540,"Greeley, CO (Metropolitan Statistical Area) *",2017,44479,245000,2661,247661,242339,13605424,305885,97.2,96.5,96.5,97.1,102.3
906,24580,"Green Bay, WI (Metropolitan Statistical Area)",2017,49044,161900,1400,163300,160500,15679209,319694,89.8,95.3,95.3,91.4,94.5
907,24660,"Greensboro-High Point, NC (Metropolitan Statistical Area)",2017,42026,143800,1243,145043,142557,32026918,762071,89.7,96.3,96.3,95.1,94.4
908,24780,"Greenville, NC (Metropolitan Statistical Area)",2017,39958,138700,3959,142659,134741,7136799,178607,87.6,96.6,96.6,95.1,92.2
909,24860,"Greenville-Anderson, SC (Metropolitan Statistical Area)",2017,42736,148700,1452,150152,147248,38263780,895357,89.9,96.4,96.4,95.1,94.6
910,25060,"Gulfport-Biloxi, MS (Metropolitan Statistical Area)",2017,35793,135300,2343,137643,132957,14773702,412754,87.1,96.5,96.5,90.6,91.7
911,25180,"Hagerstown-Martinsburg, MD-WV (Metropolitan Statistical Area)",2017,42268,186000,3375,189375,182625,11959935,282958,96.5,99.5,99.5,104.8,101.5
912,25220,"Hammond, LA (Metropolitan Statistical Area)",2017,36810,149300,6565,155865,142735,4871942,132353,85.7,92.3,92.3,90.7,90.2
913,25260,"Hanford-Corcoran, CA (Metropolitan Statistical Area)",2017,36494,185600,5792,191392,179808,5461861,149665,96.3,103.1,103.1,97.2,101.3
914,25420,"Harrisburg-Carlisle, PA (Metropolitan Statistical Area)",2017,50076,175600,1769,177369,173831,28582658,570784,95.9,98.9,98.9,97.9,100.9
915,25500,"Harrisonburg, VA (Metropolitan Statistical Area) *",2017,38828,203100,5493,208593,197607,5204496,134041,89.5,92.5,92.5,94.7,94.2
916,25540,"Hartford-East Hartford-Middletown, CT (Metropolitan Statistical Area)",2017,61228,244300,1444,245744,242856,73903654,1207027,102.8,99.2,99.2,103.9,108.2
917,25620,"Hattiesburg, MS (Metropolitan Statistical Area)",2017,37260,137100,5242,142342,131858,6249244,167719,81.9,92.3,92.3,90.1,86.2
918,25860,"Hickory-Lenoir-Morganton, NC (Metropolitan Statistical Area)",2017,38297,126000,2230,128230,123770,14058411,367085,86.9,96.6,96.6,95.1,91.4
919,25940,"Hilton Head Island-Bluffton, SC (Metropolitan Statistical Area)",2017,50863,264000,7118,271118,256882,10936461,215019,95.6,92.5,92.5,94.7,100.7
920,25980,"Hinesville, GA (Metropolitan Statistical Area)",2017,32387,120100,4299,124399,115801,2603845,80399,89.9,92.5,92.5,94.7,94.7
921,26140,"Homosassa Springs, FL (Metropolitan Statistical Area)",2017,37012,117400,3252,120652,114148,5382141,145415,87.7,92.5,92.5,94.7,92.3
922,26300,"Hot Springs, AR (Metropolitan Statistical Area)",2017,38759,131500,5120,136620,126380,3811049,98327,85.6,92.3,92.3,90.7,90.1
923,26380,"Houma-Thibodaux, LA (Metropolitan Statistical Area)",2017,41625,144000,3743,147743,140257,8739026,209946,88.9,96.5,96.5,91.4,93.6
924,26420,"Houston-The Woodlands-Sugar Land, TX (Metropolitan Statistical Area)",2017,54017,166500,657,167157,165843,372721477,6900090,101.6,95.8,95.8,106.8,106.9
925,26580,"Huntington-Ashland, WV-KY-OH (Metropolitan Statistical Area)",2017,38109,112000,2264,114264,109736,13794431,361970,85.7,96,96,94.9,90.2
926,26620,"Huntsville, AL (Metropolitan Statistical Area)",2017,47952,168000,1946,169946,166054,21860787,455892,88.4,96.7,96.7,90.6,93
927,26820,"Idaho Falls, ID (Metropolitan Statistical Area)",2017,43942,160900,2017,162917,158883,6394030,145512,91,97.7,97.7,94,95.8
928,26900,"Indianapolis-Carmel-Anderson, IN (Metropolitan Statistical Area)",2017,52196,148500,810,149310,147690,105832470,2027584,91.3,95.4,95.4,91.5,96.1
929,26980,"Iowa City, IA (Metropolitan Statistical Area)",2017,51198,198500,4239,202739,194261,8781866,171529,93.9,94.8,94.8,92.2,98.8
930,27060,"Ithaca, NY (Metropolitan Statistical Area)",2017,43732,190100,5183,195283,184917,4489721,102664,105.7,98.9,98.9,97.9,111.2
931,27100,"Jackson, MI (Metropolitan Statistical Area)",2017,37821,120100,2669,122769,117431,5997070,158563,88.1,95.4,95.4,91.5,92.7
932,27140,"Jackson, MS (Metropolitan Statistical Area)",2017,42025,139600,1970,141570,137630,25187907,599358,88.2,96.2,96.2,90.6,92.8
933,27180,"Jackson, TN (Metropolitan Statistical Area)",2017,38958,120300,3278,123578,117022,6947599,178336,80.6,92.3,92.3,90,84.9
934,27260,"Jacksonville, FL (Metropolitan Statistical Area)",2017,48231,174000,1515,175515,172485,72589393,1505033,95.3,96.5,96.5,95.1,100.3
935,27340,"Jacksonville, NC (Metropolitan Statistical Area)",2017,44865,154400,2809,157209,151591,8751673,195066,92.4,96.6,96.6,95.1,97.3
936,27500,"Janesville-Beloit, WI (Metropolitan Statistical Area)",2017,42212,135000,2029,137029,132971,6846973,162205,89.6,95.4,95.4,91.5,94.3
937,27620,"Jefferson City, MO (Metropolitan Statistical Area)",2017,41704,143900,2856,146756,141044,6310672,151319,82.2,94,94,91.5,86.5
938,27740,"Johnson City, TN (Metropolitan Statistical Area)",2017,38821,137100,2521,139621,134579,7838227,201909,86,96.7,96.7,90.6,90.5
939,27780,"Johnstown, PA (Metropolitan Statistical Area)",2017,40817,88900,1438,90338,87462,5427092,132960,85.9,98.9,98.9,98,90.4
940,27860,"Jonesboro, AR (Metropolitan Statistical Area)",2017,35714,120200,3328,123528,116872,4687796,131259,81.9,92.3,92.3,90.7,86.2
941,27900,"Joplin, MO (Metropolitan Statistical Area)",2017,38456,114500,2695,117195,111805,6854339,178239,86.2,94.8,94.8,92.3,90.8
942,27980,"Kahului-Wailuku-Lahaina, HI (Metropolitan Statistical Area)",2017,47783,569100,11976,581076,557124,7943038,166232,112.6,105.8,105.8,99.9,118.5
943,28020,"Kalamazoo-Portage, MI (Metropolitan Statistical Area)",2017,46373,141100,1876,142976,139224,12195991,262998,90.2,95.4,95.4,91.5,95
944,28100,"Kankakee, IL (Metropolitan Statistical Area)",2017,39672,140100,3132,143232,136968,4385392,110540,93.1,97.2,97.2,99.2,98
945,28140,"Kansas City, MO-KS (Metropolitan Statistical Area)",2017,51524,166800,693,167493,166107,109602196,2127203,92.8,95.9,95.9,95.3,97.6
946,28420,"Kennewick-Richland, WA (Metropolitan Statistical Area)",2017,42979,192800,2493,195293,190307,12468006,290096,97.9,98.2,98.2,101.2,103
947,28660,"Killeen-Temple, TX (Metropolitan Statistical Area)",2017,40937,132300,2034,134334,130266,18135175,442998,89.8,96.4,96.4,91.4,94.5
948,28700,"Kingsport-Bristol, TN-VA (Metropolitan Statistical Area) *",2017,38612,124000,1940,125940,122060,11834386,306496,84.2,96.6,96.6,91.6,88.7
949,28740,"Kingston, NY (Metropolitan Statistical Area)",2017,48584,221600,3272,224872,218328,8678802,178635,102.6,98.9,98.9,97.9,108
950,28940,"Knoxville, TN (Metropolitan Statistical Area)",2017,44212,158700,1128,159828,157572,37741046,853645,87.5,96.2,96.2,90.6,92.1
951,29020,"Kokomo, IN (Metropolitan Statistical Area)",2017,40069,101300,2834,104134,98466,3294072,82210,85.9,95.4,95.4,91.5,90.4
952,29100,"La Crosse-Onalaska, WI-MN (Metropolitan Statistical Area)",2017,48096,161800,2011,163811,159789,6575156,136710,91.2,95.4,95.4,91.5,96
953,29180,"Lafayette, LA (Metropolitan Statistical Area)",2017,41907,143400,3387,146787,140013,20547155,490299,86.2,95.8,95.8,91.3,90.8
954,29200,"Lafayette-West Lafayette, IN (Metropolitan Statistical Area)",2017,37595,138400,2692,141092,135708,8575483,228101,90.4,95.3,95.3,91.4,95.2
955,29340,"Lake Charles, LA (Metropolitan Statistical Area)",2017,46190,136700,4109,140809,132591,9672668,209410,88.3,96.4,96.4,91.4,92.9
956,29420,"Lake Havasu City-Kingman, AZ (Metropolitan Statistical Area)",2017,32030,138700,3711,142411,134989,6630663,207017,89.5,93,93,98.7,94.2
957,29460,"Lakeland-Winter Haven, FL (Metropolitan Statistical Area)",2017,34938,121100,1726,122826,119374,23945564,685368,92.9,96.6,96.6,95.1,97.8
958,29540,"Lancaster, PA (Metropolitan Statistical Area)",2017,50115,193200,1574,194774,191626,27129059,541332,98.7,98.9,98.9,97.9,103.9
959,29620,"Lansing-East Lansing, MI (Metropolitan Statistical Area)",2017,39699,138900,1430,140330,137470,21770280,548380,91.1,95.3,95.3,91.4,95.9
960,29700,"Laredo, TX (Metropolitan Statistical Area)",2017,30340,115500,2204,117704,113296,8303654,273691,87.4,96.5,96.5,91.4,91.9
961,29740,"Las Cruces, NM (Metropolitan Statistical Area)",2017,35153,140700,4440,145140,136260,7599194,216174,88,93,93,98.7,92.6
962,29820,"Las Vegas-Henderson-Paradise, NV (Metropolitan Statistical Area)",2017,45798,212300,1335,213635,210965,99914746,2181635,95.7,93,93,98.7,100.7
963,29940,"Lawrence, KS (Metropolitan Statistical Area)",2017,41866,188100,4149,192249,183951,5035739,120281,90.9,94.8,94.8,92.3,95.7
964,30020,"Lawton, OK (Metropolitan Statistical Area)",2017,39783,121900,3404,125304,118496,5078320,127649,88.4,96.1,96.1,91.4,93
965,30140,"Lebanon, PA (Metropolitan Statistical Area)",2017,46104,166600,2077,168677,164523,6433904,139553,94.7,98.9,98.9,97.9,99.7
966,30300,"Lewiston, ID-WA (Metropolitan Statistical Area)",2017,44061,173500,3088,176588,170412,2766970,62798,90.4,97.7,97.7,94,95.1
967,30340,"Lewiston-Auburn, ME (Metropolitan Statistical Area)",2017,39734,152000,3087,155087,148913,4267389,107399,96.1,99.1,99.1,103.8,101.2
968,30460,"Lexington-Fayette, KY (Metropolitan Statistical Area)",2017,46302,170200,1421,171621,168779,23724327,512381,89.5,96.7,96.7,90.6,94.2
969,30620,"Lima, OH (Metropolitan Statistical Area)",2017,40925,110900,2949,113849,107951,4219071,103093,85.1,95.4,95.4,91.5,89.5
970,30700,"Lincoln, NE (Metropolitan Statistical Area)",2017,47460,162700,1702,164402,160998,15708103,330975,91,94.8,94.8,92.3,95.7
971,30780,"Little Rock-North Little Rock-Conway, AR (Metropolitan Statistical Area)",2017,44042,146000,1488,147488,144512,32483575,737557,89.3,96.4,96.4,91.4,94
972,30860,"Logan, UT-ID (Metropolitan Statistical Area)",2017,37356,199100,3292,202392,195808,5144030,137703,91,97.7,97.7,94,95.8
973,30980,"Longview, TX (Metropolitan Statistical Area)",2017,39884,121100,2850,123950,118250,11351117,284602,89.8,96,96,91.3,94.5
974,31020,"Longview, WA (Metropolitan Statistical Area)",2017,42904,186600,3900,190500,182700,4582411,106805,96.1,103.1,103.1,97.2,101.1
975,31080,"Los Angeles-Long Beach-Anaheim, CA (Metropolitan Statistical Area)",2017,61159,537000,1724,538724,535276,812074093,13278000,117.9,105.9,105.9,106.6,124.1
976,31140,"Louisville/Jefferson County, KY-IN (Metropolitan Statistical Area)",2017,48038,155700,1011,156711,154689,60506530,1259553,89.4,96.4,96.4,90.6,94
977,31180,"Lubbock, TX (Metropolitan Statistical Area)",2017,40813,119900,2398,122298,117502,12941631,317094,91.9,96.3,96.3,91.4,96.7
978,31340,"Lynchburg, VA (Metropolitan Statistical Area) *",2017,38948,165700,2051,167751,163649,10197185,261813,89.6,96.4,96.4,95.1,94.3
979,31420,"Macon-Bibb County, GA (Metropolitan Statistical Area)",2017,39589,118400,4015,122415,114385,9065200,228985,86.6,95.9,95.9,95.1,91.1
980,31460,"Madera, CA (Metropolitan Statistical Area)",2017,37967,220400,5593,225993,214807,5901022,155423,95.5,98.2,98.2,101.2,100.6
981,31540,"Madison, WI (Metropolitan Statistical Area)",2017,56507,230200,1449,231649,228751,37026055,655250,96.3,95.3,95.3,91.4,101.3
982,31700,"Manchester-Nashua, NH (Metropolitan Statistical Area)",2017,58566,256300,2290,258590,254010,24199521,413204,108.6,101.3,101.3,108.2,114.3
983,31740,"Manhattan, KS (Metropolitan Statistical Area)",2017,44194,182700,4429,187129,178271,5818900,131667,92.3,94,94,91.5,97.1
984,31860,"Mankato, MN (Metropolitan Statistical Area)",2017,44548,173400,2230,175630,171170,4497887,100968,91.2,94,94,91.5,96
985,31900,"Mansfield, OH (Metropolitan Statistical Area)",2017,38074,103700,2656,106356,101044,4585240,120430,85.5,95.4,95.4,91.5,90
986,32580,"McAllen-Edinburg-Mission, TX (Metropolitan Statistical Area)",2017,25712,82400,936,83336,81464,22015991,856249,82.8,96.5,96.5,91.4,87.1
987,32780,"Medford, OR (Metropolitan Statistical Area)",2017,44955,240900,4641,245541,236259,9743846,216746,98,98.2,98.2,101.2,103.2
988,32820,"Memphis, TN-MS-AR (Metropolitan Statistical Area)",2017,45034,138200,1367,139567,136833,60282226,1338582,89.6,96.5,96.5,90.6,94.3
989,32900,"Merced, CA (Metropolitan Statistical Area)",2017,38329,196200,5679,201879,190521,10390896,271096,95.1,98.2,98.2,101.2,100.1
990,33100,"Miami-Fort Lauderdale-Pompano Beach, FL (Metropolitan Statistical Area)",2017,55505,236500,992,237492,235508,339588933,6118155,110.5,103.1,103.1,105.3,116.3
991,33140,"Michigan City-La Porte, IN (Metropolitan Statistical Area)",2017,40731,126700,3924,130624,122776,4473977,109842,84.7,94.7,94.7,90.7,89.1
992,33220,"Midland, MI (Metropolitan Statistical Area)",2017,57548,133000,3661,136661,129339,4794515,83314,90.4,95.4,95.4,91.5,95.1
993,33260,"Midland, TX (Metropolitan Statistical Area)",2017,109131,185000,5044,190044,179956,18644941,170849,98.8,96.3,96.3,91.4,103.9
994,33340,"Milwaukee-Waukesha, WI (Metropolitan Statistical Area)",2017,54194,197800,1081,198881,196719,85325685,1574444,95.1,96.4,96.4,94.2,100.1
995,33460,"Minneapolis-St. Paul-Bloomington, MN-WI (Metropolitan Statistical Area)",2017,60179,230700,677,231377,230023,215180937,3575699,102.8,105.1,105.1,96.8,108.2
996,33540,"Missoula, MT (Metropolitan Statistical Area)",2017,48144,259600,5590,265190,254010,5673031,117834,94.8,97.7,97.7,94,99.8
997,33660,"Mobile, AL (Metropolitan Statistical Area)",2017,37319,124500,1814,126314,122686,16068405,430567,85.5,96.3,96.3,90.6,90
998,33700,"Modesto, CA (Metropolitan Statistical Area)",2017,42592,244100,3173,247273,240927,23200411,544717,99.4,98.2,98.2,101.2,104.6
999,33740,"Monroe, LA (Metropolitan Statistical Area)",2017,38721,126600,4319,130919,122281,7894937,203894,83,95.9,95.9,91.3,87.4
1000,33780,"Monroe, MI (Metropolitan Statistical Area)",2017,45252,149500,3011,152511,146489,6762911,149449,91.5,97.7,97.7,95.9,96.4
1001,33860,"Montgomery, AL (Metropolitan Statistical Area)",2017,42095,132800,2499,135299,130301,15751012,374174,87.5,96.6,96.6,90.6,92.1
1002,34060,"Morgantown, WV (Metropolitan Statistical Area)",2017,41129,157300,3908,161208,153392,5741980,139608,91.5,92.5,92.5,94.6,96.3
1003,34100,"Morristown, TN (Metropolitan Statistical Area)",2017,34842,133200,3191,136391,130009,4909219,140898,80.5,92.5,92.5,89.9,84.7
1004,34580,"Mount Vernon-Anacortes, WA (Metropolitan Statistical Area)",2017,49436,269100,4301,273401,264799,6221979,125860,101.1,103.1,103.1,97.2,106.4
1005,34620,"Muncie, IN (Metropolitan Statistical Area)",2017,35842,88600,1925,90525,86675,4130590,115246,85.5,95.4,95.4,91.5,90
1006,34740,"Muskegon, MI (Metropolitan Statistical Area)",2017,36971,105300,1995,107295,103305,6419878,173645,86.6,95.4,95.4,91.5,91.1
1007,34820,"Myrtle Beach-Conway-North Myrtle Beach, SC-NC (Metropolitan Statistical Area)",2017,37747,172200,1720,173920,170480,17496097,463514,92.1,95.5,95.5,95.1,96.9
1008,34900,"Napa, CA (Metropolitan Statistical Area)",2017,70649,560500,8513,569013,551987,9882187,139878,121.3,109.8,109.8,110.3,127.7
1009,34940,"Naples-Marco Island, FL (Metropolitan Statistical Area)",2017,89607,316200,5943,322143,310257,33394573,372678,101.6,96.6,96.6,95.1,107
1010,34980,"Nashville-Davidson--Murfreesboro--Franklin, TN (Metropolitan Statistical Area)",2017,55729,197000,1190,198190,195810,104464974,1874515,93.6,96.5,96.5,90.6,98.5
1011,35100,"New Bern, NC (Metropolitan Statistical Area)",2017,41850,151200,3523,154723,147677,5218826,124703,84.5,92.5,92.5,94.7,89
1012,35300,"New Haven-Milford, CT (Metropolitan Statistical Area)",2017,53582,244400,1989,246389,242411,45960269,857748,107.5,104,104,107.6,113.1
1013,35380,"New Orleans-Metairie, LA (Metropolitan Statistical Area)",2017,50015,184100,1468,185568,182632,63535209,1270326,93.8,96.4,96.4,91.4,98.7
1014,35620,"New York-Newark-Jersey City, NY-NJ-PA (Metropolitan Statistical Area)",2017,73093,413200,916,414116,412284,1412351029,19322607,124.6,109.8,109.8,123,131.2
1015,35660,"Niles, MI (Metropolitan Statistical Area)",2017,45376,140900,2781,143681,138119,6993722,154128,87.7,95.4,95.4,91.5,92.3
1016,35840,"North Port-Sarasota-Bradenton, FL (Metropolitan Statistical Area)",2017,54813,207600,2653,210253,204947,44134891,805186,99.9,96.6,96.6,95.1,105.1
1017,35980,"Norwich-New London, CT (Metropolitan Statistical Area)",2017,56543,238900,2928,241828,235972,15120632,267419,102.9,99.1,99.1,103.8,108.3
1018,36100,"Ocala, FL (Metropolitan Statistical Area)",2017,36141,119200,2694,121894,116506,12770003,353339,90.5,96.6,96.6,95.1,95.2
1019,36140,"Ocean City, NJ (Metropolitan Statistical Area)",2017,58019,295500,5401,300901,290099,5403297,93129,101.6,100.5,100.5,100.8,106.9
1020,36220,"Odessa, TX (Metropolitan Statistical Area)",2017,42824,120800,3446,124246,117354,6721220,156951,94.3,96.5,96.5,91.4,99.2
1021,36260,"Ogden-Clearfield, UT (Metropolitan Statistical Area)",2017,41878,220600,1533,222133,219067,27808940,664040,92.8,93.4,93.4,98.3,97.6
1022,36420,"Oklahoma City, OK (Metropolitan Statistical Area)",2017,46034,146800,931,147731,145869,63595536,1381492,90.1,96.4,96.4,91.4,94.8
1023,36500,"Olympia-Lacey-Tumwater, WA (Metropolitan Statistical Area)",2017,48569,255500,3363,258863,252137,13612403,280269,107.1,106.6,106.6,104.5,112.7
1024,36540,"Omaha-Council Bluffs, NE-IA (Metropolitan Statistical Area)",2017,54968,157500,920,158420,156580,51228997,931987,92,94.8,94.8,92.3,96.8
1025,36740,"Orlando-Kissimmee-Sanford, FL (Metropolitan Statistical Area)",2017,41906,180100,1657,181757,178443,105508915,2517777,98.3,96.6,96.6,95.1,103.4
1026,36780,"Oshkosh-Neenah, WI (Metropolitan Statistical Area)",2017,46047,147300,1969,149269,145331,7846139,170394,89.8,95.4,95.4,91.5,94.5
1027,36980,"Owensboro, KY (Metropolitan Statistical Area)",2017,39931,119700,2534,122234,117166,4729977,118455,86.7,96.2,96.2,90.6,91.2
1028,37100,"Oxnard-Thousand Oaks-Ventura, CA (Metropolitan Statistical Area)",2017,58970,520300,5294,525594,515006,50067967,849044,117.8,101.8,101.8,106.7,124
1029,37340,"Palm Bay-Melbourne-Titusville, FL (Metropolitan Statistical Area)",2017,43733,162400,1836,164236,160564,25705081,587769,95.8,96.6,96.6,95.1,100.9
1030,37460,"Panama City, FL (Metropolitan Statistical Area)",2017,41658,165200,3071,168271,162129,7695669,184736,94.4,96.6,96.6,95.1,99.4
1031,37620,"Parkersburg-Vienna, WV (Metropolitan Statistical Area)",2017,39197,112300,3620,115920,108680,3560894,90846,87.9,96.4,96.4,95.1,92.5
1032,37860,"Pensacola-Ferry Pass-Brent, FL (Metropolitan Statistical Area)",2017,41937,145500,2710,148210,142790,20435790,487298,92.3,96.6,96.6,95.1,97.1
1033,37900,"Peoria, IL (Metropolitan Statistical Area)",2017,46174,133300,1700,135000,131600,18788985,406913,88.4,95.3,95.3,91.4,93
1034,37980,"Philadelphia-Camden-Wilmington, PA-NJ-DE-MD (Metropolitan Statistical Area)",2017,61353,240700,708,241408,239992,372935043,6078522,105.1,99.9,99.9,108.3,110.6
1035,38060,"Phoenix-Mesa-Chandler, AZ (Metropolitan Statistical Area)",2017,44327,216600,857,217457,215743,210943307,4758748,97.7,94.4,94.4,100.8,102.8
1036,38220,"Pine Bluff, AR (Metropolitan Statistical Area)",2017,33353,79900,2558,82458,77342,3030944,90875,81.6,95.9,95.9,91.3,85.9
1037,38300,"Pittsburgh, PA (Metropolitan Statistical Area)",2017,54583,142100,813,142913,141287,127122890,2329004,93,98.9,98.9,93.3,97.9
1038,38340,"Pittsfield, MA (Metropolitan Statistical Area)",2017,54396,203300,5036,208336,198264,6873118,126353,98.8,99.1,99.1,103.8,103.9
1039,38540,"Pocatello, ID (Metropolitan Statistical Area)",2017,36957,148300,2787,151087,145513,3440293,93088,87.8,97.6,97.6,94,92.4
1040,38860,"Portland-South Portland, ME (Metropolitan Statistical Area)",2017,54918,243800,2081,245881,241719,29211089,531899,103.3,99.2,99.2,104.2,108.8
1041,38900,"Portland-Vancouver-Hillsboro, OR-WA (Metropolitan Statistical Area)",2017,54339,312500,1737,314237,310763,133392595,2454815,103.6,101.8,101.8,97.3,109
1042,38940,"Port St. Lucie, FL (Metropolitan Statistical Area)",2017,52836,167200,2598,169798,164602,24984041,472864,97,96.6,96.6,95.1,102.1
1043,39300,"Providence-Warwick, RI-MA (Metropolitan Statistical Area)",2017,52344,257300,1667,258967,255633,84620511,1616614,100.6,99.5,99.5,104.7,105.9
1044,39340,"Provo-Orem, UT (Metropolitan Statistical Area)",2017,38789,255100,1996,257096,253104,23972815,618035,95.1,93,93,98.6,100.1
1045,39380,"Pueblo, CO (Metropolitan Statistical Area)",2017,37462,148000,2356,150356,145644,6229243,166283,89.7,93,93,98.7,94.4
1046,39460,"Punta Gorda, FL (Metropolitan Statistical Area)",2017,40281,165200,3334,168534,161866,7311906,181522,95.5,96.6,96.6,95.1,100.5
1047,39540,"Racine, WI (Metropolitan Statistical Area)",2017,47418,165200,2723,167923,162477,9285649,195825,92.9,96.4,96.4,94.2,97.8
1048,39580,"Raleigh-Cary, NC (Metropolitan Statistical Area)",2017,52609,224800,1722,226522,223078,70193280,1334235,96.2,96.6,96.6,95.1,101.2
1049,39660,"Rapid City, SD (Metropolitan Statistical Area)",2017,47916,172600,2958,175558,169642,6633745,138444,89.9,94.7,94.7,92.2,94.6
1050,39740,"Reading, PA (Metropolitan Statistical Area)",2017,47629,170900,1669,172569,169231,19885496,417511,95.5,98.9,98.9,97.9,100.5
1051,39820,"Redding, CA (Metropolitan Statistical Area)",2017,44808,233500,4093,237593,229407,8037785,179384,97.7,98.2,98.2,101.2,102.8
1052,39900,"Reno, NV (Metropolitan Statistical Area)",2017,57070,267200,2563,269763,264637,26286758,460605,96.9,93,93,98.6,101.9
1053,40060,"Richmond, VA (Metropolitan Statistical Area) *",2017,55548,220400,1499,221899,218901,70521983,1269566,96.1,96.5,96.5,95.1,101.1
1054,40140,"Riverside-San Bernardino-Ontario, CA (Metropolitan Statistical Area)",2017,38972,293800,1361,295161,292439,177943888,4565909,106.5,99,99,107,112.1
1055,40220,"Roanoke, VA (Metropolitan Statistical Area) *",2017,45414,173100,2173,175273,170927,14214104,312988,90.1,96,96,95.1,94.9
1056,40340,"Rochester, MN (Metropolitan Statistical Area)",2017,52427,179700,2108,181808,177592,11428741,217993,93.1,94.7,94.7,92.2,98
1057,40380,"Rochester, NY (Metropolitan Statistical Area)",2017,49729,138300,744,139044,137556,53307457,1071962,97.1,98.9,98.9,97.9,102.2
1058,40420,"Rockford, IL (Metropolitan Statistical Area)",2017,42342,119700,1572,121272,118128,14319722,338194,87.9,95.4,95.4,91.5,92.5
1059,40580,"Rocky Mount, NC (Metropolitan Statistical Area)",2017,38263,104500,2957,107457,101543,5616007,146775,84.7,96.6,96.6,95.1,89.1
1060,40660,"Rome, GA (Metropolitan Statistical Area)",2017,37072,126600,4592,131192,122008,3614529,97500,81.9,92.5,92.5,94.6,86.2
1061,40900,"Sacramento-Roseville-Folsom, CA (Metropolitan Statistical Area)",2017,54245,339500,1574,341074,337926,125826082,2319572,103.5,98.2,98.2,101.2,108.9
1062,40980,"Saginaw, MI (Metropolitan Statistical Area)",2017,37203,94900,1899,96799,93001,7141643,191965,87.1,95.4,95.4,91.5,91.7
1063,41060,"St. Cloud, MN (Metropolitan Statistical Area)",2017,44700,169300,1575,170875,167725,8870147,198436,90.4,94.8,94.8,92.3,95.2
1064,41100,"St. George, UT (Metropolitan Statistical Area)",2017,37043,240300,5066,245366,235234,6146500,165929,94.2,97.7,97.7,94,99.2
1065,41140,"St. Joseph, MO-KS (Metropolitan Statistical Area)",2017,37831,116600,2807,119407,113793,4778976,126323,85.8,94.8,94.8,92.2,90.3
1066,41180,"St. Louis, MO-IL (Metropolitan Statistical Area)",2017,52395,162600,686,163286,161914,147006378,2805758,91.1,96.4,96.4,89.7,95.9
1067,41420,"Salem, OR (Metropolitan Statistical Area)",2017,41055,210100,2352,212452,207748,17417343,424242,97.8,101.8,101.8,97.3,103
1068,41500,"Salinas, CA (Metropolitan Statistical Area)",2017,54691,441000,6591,447591,434409,23765296,434534,109.9,98.2,98.2,101.2,115.7
1069,41540,"Salisbury, MD-DE (Metropolitan Statistical Area)",2017,47245,220900,2969,223869,217931,19094118,404155,89.3,92.5,92.5,94.7,94
1070,41620,"Salt Lake City, UT (Metropolitan Statistical Area)",2017,49254,255100,1877,256977,253223,59311382,1204205,97.2,93.2,93.2,98.5,102.3
1071,41660,"San Angelo, TX (Metropolitan Statistical Area)",2017,44254,122700,3747,126447,118953,5326599,120365,91.9,96.4,96.4,91.4,96.7
1072,41700,"San Antonio-New Braunfels, TX (Metropolitan Statistical Area)",2017,45181,152400,988,153388,151412,111692518,2472121,93,96.3,96.3,91.4,97.9
1073,41740,"San Diego-Chula Vista-Carlsbad, CA (Metropolitan Statistical Area)",2017,58380,484900,2026,486926,482874,193892473,3321237,117.9,100.5,100.5,109.3,124.1
1074,41860,"San Francisco-Oakland-Berkeley, CA (Metropolitan Statistical Area)",2017,93165,716500,2573,719073,713927,439032236,4712421,131.6,114.7,114.7,118.3,138.5
1075,41940,"San Jose-Sunnyvale-Santa Clara, CA (Metropolitan Statistical Area)",2017,99176,815000,4380,819380,810620,197624722,1992674,128.6,109.7,109.7,110.1,135.4
1076,42020,"San Luis Obispo-Paso Robles, CA (Metropolitan Statistical Area)",2017,55580,499800,9363,509163,490437,15700229,282481,109,98.2,98.2,101.2,114.7
1077,42100,"Santa Cruz-Watsonville, CA (Metropolitan Statistical Area)",2017,64731,659900,9193,669093,650707,17791731,274856,125.2,109.8,109.8,110.3,131.7
1078,42140,"Santa Fe, NM (Metropolitan Statistical Area)",2017,55063,277700,4557,282257,273143,8231475,149491,96.8,93,93,98.7,101.9
1079,42200,"Santa Maria-Santa Barbara, CA (Metropolitan Statistical Area)",2017,59894,509400,17381,526781,492019,26670875,445298,111.2,98.2,98.2,101.2,117
1080,42220,"Santa Rosa-Petaluma, CA (Metropolitan Statistical Area)",2017,60027,513300,7447,520747,505853,30161812,502469,121.3,109.8,109.8,110.3,127.7
1081,42340,"Savannah, GA (Metropolitan Statistical Area)",2017,45103,173300,2083,175383,171217,17427373,386394,93.9,96.6,96.6,95.1,98.8
1082,42540,"Scranton--Wilkes-Barre, PA (Metropolitan Statistical Area)",2017,43976,136300,1638,137938,134662,24435739,555655,91.7,98.9,98.9,97.9,96.5
1083,42660,"Seattle-Tacoma-Bellevue, WA (Metropolitan Statistical Area)",2017,69844,365400,1106,366506,364294,271383679,3885579,112.6,108.3,108.3,104.4,118.5
1084,42680,"Sebastian-Vero Beach, FL (Metropolitan Statistical Area)",2017,74267,172600,4185,176785,168415,11454945,154241,92.6,92.5,92.5,94.7,97.4
1085,42700,"Sebring-Avon Park, FL (Metropolitan Statistical Area)",2017,33011,87900,2810,90710,85090,3428227,103852,84.1,92.5,92.5,94.7,88.5
1086,43100,"Sheboygan, WI (Metropolitan Statistical Area)",2017,50830,149800,2581,152381,147219,5849961,115089,89.2,95.4,95.4,91.5,93.9
1087,43300,"Sherman-Denison, TX (Metropolitan Statistical Area)",2017,40793,116600,3908,120508,112692,5350091,131152,90.4,96.5,96.5,91.4,95.2
1088,43340,"Shreveport-Bossier City, LA (Metropolitan Statistical Area)",2017,43863,138700,3466,142166,135234,17552237,400161,87.7,96.3,96.3,91.4,92.3
1089,43420,"Sierra Vista-Douglas, AZ (Metropolitan Statistical Area)",2017,39060,144400,3822,148222,140578,4877224,124864,88.2,97.7,97.7,94,92.8
1090,43580,"Sioux City, IA-NE-SD (Metropolitan Statistical Area)",2017,47827,119900,2247,122147,117653,6847208,143165,88.1,94.7,94.7,92.2,92.8
1091,43620,"Sioux Falls, SD (Metropolitan Statistical Area)",2017,57456,171000,1450,172450,169550,14943379,260083,91,94.8,94.8,92.3,95.8
1092,43780,"South Bend-Mishawaka, IN-MI (Metropolitan Statistical Area)",2017,45428,120200,1796,121996,118404,14606973,321538,87.6,95.3,95.3,91.4,92.2
1093,43900,"Spartanburg, SC (Metropolitan Statistical Area)",2017,41803,122300,1948,124248,120352,12822583,306740,89.7,96.6,96.6,95.1,94.4
1094,44060,"Spokane-Spokane Valley, WA (Metropolitan Statistical Area)",2017,43923,194400,1870,196270,192530,24168968,550259,96.2,98.8,98.8,100.7,101.3
1095,44100,"Springfield, IL (Metropolitan Statistical Area)",2017,46387,135900,2040,137940,133860,9711836,209365,89.2,95.4,95.4,91.5,93.9
1096,44140,"Springfield, MA (Metropolitan Statistical Area)",2017,50283,217500,1682,219182,215818,35167317,699387,98.7,99.1,99.1,103.9,103.9
1097,44180,"Springfield, MO (Metropolitan Statistical Area)",2017,40025,137000,1705,138705,135295,18495016,462090,86.6,94.8,94.8,92.2,91.2
1098,44220,"Springfield, OH (Metropolitan Statistical Area)",2017,39445,107300,2133,109433,105167,5307351,134549,86,95.4,95.4,91.5,90.5
1099,44300,"State College, PA (Metropolitan Statistical Area)",2017,44720,212300,3710,216010,208590,7258779,162316,101.6,98.9,98.9,97.9,106.9
1100,44420,"Staunton, VA (Metropolitan Statistical Area) *",2017,42815,189400,4074,193474,185326,5212524,121744,85.4,92.5,92.5,94.7,89.9
1101,44700,"Stockton, CA (Metropolitan Statistical Area)",2017,42917,281100,3375,284475,277725,31900044,743296,100.8,98.2,98.2,101.2,106.1
1102,44940,"Sumter, SC (Metropolitan Statistical Area)",2017,35818,113200,4328,117528,108872,5030346,140443,86.8,94.6,94.6,95.1,91.3
1103,45060,"Syracuse, NY (Metropolitan Statistical Area)",2017,48148,131100,1213,132313,129887,31352558,651164,96.1,98.9,98.9,97.9,101.2
1104,45220,"Tallahassee, FL (Metropolitan Statistical Area)",2017,40866,167600,2421,170021,165179,15658641,383173,93.3,96.2,96.2,95.1,98.2
1105,45300,"Tampa-St. Petersburg-Clearwater, FL (Metropolitan Statistical Area)",2017,45468,162600,772,163372,161828,141265900,3106922,97.6,92.6,92.6,100.4,102.7
1106,45460,"Terre Haute, IN (Metropolitan Statistical Area)",2017,36764,88400,1429,89829,86971,6869220,186846,86.5,95.2,95.2,91.4,91
1107,45500,"Texarkana, TX-AR (Metropolitan Statistical Area)",2017,36862,104200,3552,107752,100648,5513347,149567,86.2,95.6,95.6,91.4,90.7
1108,45540,"The Villages, FL (Metropolitan Statistical Area)",2017,44741,239800,5493,245293,234307,5592394,124995,93.6,92.5,92.5,94.8,98.5
1109,45780,"Toledo, OH (Metropolitan Statistical Area)",2017,44780,120500,1413,121913,119087,28854450,644364,87,95.3,95.3,91.4,91.6
1110,45820,"Topeka, KS (Metropolitan Statistical Area)",2017,43840,126500,2074,128574,124426,10214471,232994,88.4,94.7,94.7,92.1,93.1
1111,45940,"Trenton-Princeton, NJ (Metropolitan Statistical Area)",2017,66045,281900,3592,285492,278308,24315524,368168,107,100.5,100.5,106.4,112.6
1112,46060,"Tucson, AZ (Metropolitan Statistical Area)",2017,42245,166300,973,167273,165327,43359677,1026391,93.3,93,93,98.7,98.2
1113,46140,"Tulsa, OK (Metropolitan Statistical Area)",2017,51258,139100,780,139880,138320,50813728,991330,89.1,96.4,96.4,91.4,93.8
1114,46220,"Tuscaloosa, AL (Metropolitan Statistical Area)",2017,37050,152300,2594,154894,149706,9297073,250933,86.6,95.8,95.8,90.6,91.1
1115,46300,"Twin Falls, ID (Metropolitan Statistical Area)",2017,38197,152600,3531,156131,149069,4168908,109142,90.4,97.7,97.7,94,95.1
1116,46340,"Tyler, TX (Metropolitan Statistical Area)",2017,52319,144800,3365,148165,141435,11886718,227195,92.5,96.5,96.5,91.4,97.4
1117,46520,"Urban Honolulu, HI (Metropolitan Statistical Area)",2017,57352,626400,3236,629636,623164,56569569,986353,123.9,114.9,114.9,105.5,130.4
1118,46540,"Utica-Rome, NY (Metropolitan Statistical Area)",2017,42874,114600,1522,116122,113078,12526698,292174,92.6,98.9,98.9,97.9,97.4
1119,46660,"Valdosta, GA (Metropolitan Statistical Area)",2017,34900,120200,3790,123990,116410,5073054,145360,82.2,92.5,92.5,94.7,86.5
1120,46700,"Vallejo, CA (Metropolitan Statistical Area)",2017,48593,342000,3580,345580,338420,21551350,443511,117.9,109.8,109.8,110.3,124.1
1121,47020,"Victoria, TX (Metropolitan Statistical Area)",2017,44113,129200,5922,135122,123278,4393566,99597,92.3,96.3,96.3,91.4,97.2
1122,47220,"Vineland-Bridgeton, NJ (Metropolitan Statistical Area)",2017,38807,160500,1892,162392,158608,5876220,151423,96.2,100.5,100.5,100.8,101.3
1123,47260,"Virginia Beach-Norfolk-Newport News, VA-NC (Metropolitan Statistical Area) *",2017,48687,236600,1060,237660,235540,85734044,1760926,97.2,96.4,96.4,95.1,102.4
1124,47300,"Visalia, CA (Metropolitan Statistical Area)",2017,39670,180200,3248,183448,176952,18339648,462308,95.2,98.2,98.2,101.2,100.2
1125,47380,"Waco, TX (Metropolitan Statistical Area)",2017,39448,120700,2489,123189,118211,10610325,268971,89.9,96.1,96.1,91.4,94.6
1126,47460,"Walla Walla, WA (Metropolitan Statistical Area)",2017,43979,193800,5333,199133,188467,2661237,60512,98,103.1,103.1,97.2,103.1
1127,47580,"Warner Robins, GA (Metropolitan Statistical Area)",2017,40653,133600,3835,137435,129765,7324093,180163,88.7,96.6,96.6,95.1,93.4
1128,47900,"Washington-Arlington-Alexandria, DC-VA-MD-WV (Metropolitan Statistical Area) *",2017,69679,397900,1108,399008,396792,432801229,6211341,116.5,103.7,103.7,107.5,122.6
1129,47940,"Waterloo-Cedar Falls, IA (Metropolitan Statistical Area)",2017,43703,141300,2126,143426,139174,7401454,169359,89.8,94.7,94.7,92.1,94.6
1130,48060,"Watertown-Fort Drum, NY (Metropolitan Statistical Area)",2017,45611,149300,3782,153082,145518,5161221,113157,98,98.9,98.9,97.9,103.1
1131,48140,"Wausau-Weston, WI (Metropolitan Statistical Area)",2017,47284,147600,2161,149761,145439,7716899,163203,89.2,95.3,95.3,91.4,93.9
1132,48260,"Weirton-Steubenville, WV-OH (Metropolitan Statistical Area)",2017,38673,89400,1569,90969,87831,4566278,118074,83.9,94.5,94.5,93.3,88.3
1133,48300,"Wenatchee, WA (Metropolitan Statistical Area)",2017,47806,245800,5457,251257,240343,5656612,118325,98.9,103.1,103.1,97.2,104.1
1134,48540,"Wheeling, WV-OH (Metropolitan Statistical Area)",2017,45940,101400,2741,104141,98659,6489253,141255,85.3,96.6,96.6,95.1,89.7
1135,48620,"Wichita, KS (Metropolitan Statistical Area)",2017,48663,129300,1191,130491,128109,31022918,637511,88.8,94.8,94.8,92.3,93.5
1136,48660,"Wichita Falls, TX (Metropolitan Statistical Area)",2017,41757,94500,2078,96578,92422,6303453,150956,87.8,96.3,96.3,91.4,92.4
1137,48700,"Williamsport, PA (Metropolitan Statistical Area)",2017,41766,147400,3322,150722,144078,4761852,114012,91.9,98.9,98.9,97.9,96.8
1138,48900,"Wilmington, NC (Metropolitan Statistical Area)",2017,42137,213500,4193,217693,209307,12196417,289447,92.8,96,96,95.1,97.6
1139,49020,"Winchester, VA-WV (Metropolitan Statistical Area) *",2017,46478,216500,5386,221886,211114,6414892,138020,93,92.5,92.5,94.7,97.8
1140,49180,"Winston-Salem, NC (Metropolitan Statistical Area)",2017,43630,145000,1449,146449,143551,29085187,666640,88.7,96.6,96.6,95.1,93.3
1141,49340,"Worcester, MA-CT (Metropolitan Statistical Area)",2017,53395,250400,2183,252583,248217,50305783,942147,103.8,101.1,101.1,107.9,109.3
1142,49420,"Yakima, WA (Metropolitan Statistical Area)",2017,41752,163500,2311,165811,161189,10434635,249922,94,98.2,98.2,101.2,98.9
1143,49620,"York-Hanover, PA (Metropolitan Statistical Area)",2017,47965,170300,1338,171638,168962,21367688,445484,95.6,98.9,98.9,97.9,100.6
1144,49660,"Youngstown-Warren-Boardman, OH-PA (Metropolitan Statistical Area)",2017,40623,103100,1256,104356,101844,21999089,541545,86,95.8,95.8,93,90.5
1145,49700,"Yuba City, CA (Metropolitan Statistical Area)",2017,41676,223700,5275,228975,218425,7200914,172782,97.8,98.2,98.2,101.2,103
1146,49740,"Yuma, AZ (Metropolitan Statistical Area) *",2017,33969,117000,2415,119415,114585,7116699,209507,88.8,93,93,98.7,93.5
1147,10180,"Abilene, TX (Metropolitan Statistical Area)",2016,39983,98200,1916,100116,96284,6797808,170017,90.8,96.7,79.3,92.6,94
1148,10420,"Akron, OH (Metropolitan Statistical Area)",2016,45704,138400,1124,139524,137276,32153668,703524,90.3,95.8,76.6,91.8,93.5
1149,10500,"Albany, GA (Metropolitan Statistical Area)",2016,35702,108300,2752,111052,105548,5324540,149137,83.4,96.7,54.9,94.6,86.4
1150,10540,"Albany-Lebanon, OR (Metropolitan Statistical Area)",2016,39396,173100,3542,176642,169558,4836624,122769,96.1,101.8,87.8,95.7,99.5
1151,10580,"Albany-Schenectady-Troy, NY (Metropolitan Statistical Area)",2016,53620,200100,1637,201737,198463,47174310,879792,100.4,98.6,104.9,100,103.9
1152,10740,"Albuquerque, NM (Metropolitan Statistical Area) *",2016,40241,177900,1742,179642,176158,36588821,909237,94.8,93.7,89.9,99.9,98.2
1153,10780,"Alexandria, LA (Metropolitan Statistical Area)",2016,40524,123300,3727,127027,119573,6245761,154124,87.2,96.9,65.9,92.6,90.3
1154,10900,"Allentown-Bethlehem-Easton, PA-NJ (Metropolitan Statistical Area)",2016,50040,200000,1600,201600,198400,41691305,833163,100.5,98.9,101.3,101.8,104
1155,11020,"Altoona, PA (Metropolitan Statistical Area)",2016,42943,112600,2264,114864,110336,5312333,123708,90.2,98.6,64.5,100,93.4
1156,11100,"Amarillo, TX (Metropolitan Statistical Area)",2016,43257,125500,2216,127716,123284,11376011,262987,92.4,97.2,83.7,92.6,95.7
1157,11180,"Ames, IA (Metropolitan Statistical Area)",2016,40658,167800,3074,170874,164726,5013518,123309,90.8,93.6,87.1,90.6,94
1158,11260,"Anchorage, AK (Metropolitan Statistical Area)",2016,57857,279500,2118,281618,277382,23221930,401368,108.8,102.1,145.1,99.5,112.6
1159,11460,"Ann Arbor, MI (Metropolitan Statistical Area)",2016,54115,218100,2433,220533,215667,19813370,366135,100.8,98.3,113.7,96.9,104.4
1160,11500,"Anniston-Oxford, AL (Metropolitan Statistical Area)",2016,34920,107900,2948,110848,104952,4014894,114973,83.2,97.4,53,91.9,86.1
1161,11540,"Appleton, WI (Metropolitan Statistical Area)",2016,47734,159200,1512,160712,157688,11179260,234200,90.7,96.1,77.5,91.6,93.9
1162,11700,"Asheville, NC (Metropolitan Statistical Area)",2016,41862,187700,3233,190933,184467,18850941,450310,92.9,95.8,86.7,94.6,96.2
1163,12020,"Athens-Clarke County, GA (Metropolitan Statistical Area)",2016,37388,159200,3007,162207,156193,7679520,205402,91.1,97.2,77.5,94.6,94.3
1164,12060,"Atlanta-Sandy Springs-Alpharetta, GA (Metropolitan Statistical Area)",2016,48272,173300,632,173932,172668,279395622,5787965,96.9,98.7,93.3,97.3,100.3
1165,12100,"Atlantic City-Hammonton, NJ (Metropolitan Statistical Area)",2016,45406,222200,3297,225497,218903,12133315,267217,102,100.9,100.5,104,105.5
1166,12220,"Auburn-Opelika, AL (Metropolitan Statistical Area)",2016,35938,156400,3727,160127,152673,5720244,159168,84.2,91.9,70.5,91.4,87.2
1167,12260,"Augusta-Richmond County, GA-SC (Metropolitan Statistical Area)",2016,39090,130700,2097,132797,128603,23259479,595029,88.4,97.1,68.5,94.6,91.5
1168,12420,"Austin-Round Rock-Georgetown, TX (Metropolitan Statistical Area)",2016,52403,223500,1650,225150,221850,108054841,2062016,99.5,97.4,116.8,92.6,103
1169,12540,"Bakersfield, CA (Metropolitan Statistical Area)",2016,37789,175600,2269,177869,173331,33286588,880856,96.9,96.4,91.4,101.6,100.3
1170,12580,"Baltimore-Columbia-Towson, MD (Metropolitan Statistical Area)",2016,57931,280500,1248,281748,279252,161864493,2794111,107.2,103.2,115.8,105.1,110.9
1171,12620,"Bangor, ME (Metropolitan Statistical Area)",2016,38752,137000,2863,139863,134137,5864423,151333,96.7,98.7,85.7,102.8,100.1
1172,12700,"Barnstable Town, MA (Metropolitan Statistical Area)",2016,68267,367200,3367,370567,363833,14579039,213559,104.8,98.7,120.7,102.8,108.5
1173,12940,"Baton Rouge, LA (Metropolitan Statistical Area)",2016,44372,164500,1301,165801,163199,38014545,856723,92.3,96.2,85.7,92.6,95.6
1174,12980,"Battle Creek, MI (Metropolitan Statistical Area)",2016,37703,99400,2102,101502,97298,5065180,134344,89.4,96.1,74.3,91.6,92.5
1175,13020,"Bay City, MI (Metropolitan Statistical Area)",2016,39366,94500,2071,96571,92429,4110220,104411,86.1,96.1,61.5,91.6,89.1
1176,13140,"Beaumont-Port Arthur, TX (Metropolitan Statistical Area)",2016,41589,99900,2119,102019,97781,16491469,396539,89.5,97.4,71.3,92.6,92.7
1177,13220,"Beckley, WV (Metropolitan Statistical Area)",2016,34369,92900,4439,97339,88461,4140593,120475,79,92.1,53.9,94.3,81.8
1178,13380,"Bellingham, WA (Metropolitan Statistical Area)",2016,44926,283000,3870,286870,279130,9722678,216417,99.7,96.4,103.4,101.6,103.2
1179,13460,"Bend, OR (Metropolitan Statistical Area)",2016,49737,275300,6340,281640,268960,8985844,180666,100.5,101.8,104.9,95.7,104
1180,13740,"Billings, MT (Metropolitan Statistical Area)",2016,47992,202200,3183,205383,199017,8530962,177759,95.9,94.4,93.8,99.2,99.2
1181,13780,"Binghamton, NY (Metropolitan Statistical Area)",2016,40968,112300,1610,113910,110690,9968422,243322,95.8,98.6,85.2,100,99.2
1182,13820,"Birmingham-Hoover, AL (Metropolitan Statistical Area)",2016,46948,149000,1403,150403,147597,50839352,1082877,88.6,97.2,69.4,91.9,91.7
1183,13900,"Bismarck, ND (Metropolitan Statistical Area)",2016,54447,206700,4357,211057,202343,6927416,127233,93.8,95.4,92.8,92.4,97.1
1184,13980,"Blacksburg-Christiansburg, VA (Metropolitan Statistical Area) *",2016,35567,164100,2973,167073,161127,5924430,166572,88.6,92.1,79.7,94.3,91.7
1185,14010,"Bloomington, IL (Metropolitan Statistical Area)",2016,46852,156700,1993,158693,154707,8108610,173070,93.1,96.1,89.6,91.6,96.4
1186,14020,"Bloomington, IN (Metropolitan Statistical Area)",2016,37923,153100,3206,156306,149894,6320029,166655,92.6,95.9,88.8,91.4,95.9
1187,14100,"Bloomsburg-Berwick, PA (Metropolitan Statistical Area)",2016,42368,147500,3298,150798,144202,3575460,84390,93.5,98.6,75.2,100,96.8
1188,14260,"Boise City, ID (Metropolitan Statistical Area)",2016,42219,176600,2242,178842,174358,29185239,691285,93.3,93.8,83.1,99.8,96.6
1189,14460,"Boston-Cambridge-Newton, MA-NH (Metropolitan Statistical Area)",2016,71794,379200,996,380196,378204,345262564,4809061,112.9,102.9,140.7,110.2,116.9
1190,14500,"Boulder, CO (Metropolitan Statistical Area) *",2016,65363,391000,5017,396017,385983,20997911,321250,107.3,97.9,144,98.1,111.1
1191,14540,"Bowling Green, KY (Metropolitan Statistical Area)",2016,34962,129300,3248,132548,126052,6010065,171902,84.9,91.7,65.3,91.8,87.9
1192,14740,"Bremerton-Silverdale-Port Orchard, WA (Metropolitan Statistical Area)",2016,50498,262400,3889,266289,258511,13288233,263142,106.8,106.8,110.8,104.3,110.5
1193,14860,"Bridgeport-Stamford-Norwalk, CT (Metropolitan Statistical Area)",2016,107593,413400,4573,417973,408827,101605049,944347,116.4,107.4,147.5,111.6,120.4
1194,15180,"Brownsville-Harlingen, TX (Metropolitan Statistical Area)",2016,27122,79900,1375,81275,78525,11427833,421350,83.3,97.4,56.9,92.6,86.2
1195,15260,"Brunswick, GA (Metropolitan Statistical Area)",2016,38071,134100,7064,141164,127036,4437939,116571,86.2,92.1,72.9,94.3,89.3
1196,15380,"Buffalo-Cheektowaga, NY (Metropolitan Statistical Area)",2016,46397,129800,853,130653,128947,52438950,1130232,94.4,98.6,78,100,97.7
1197,15500,"Burlington, NC (Metropolitan Statistical Area)",2016,37576,143500,2715,146215,140785,6022761,160283,89.7,97.5,71,94.6,92.8
1198,15540,"Burlington-South Burlington, VT (Metropolitan Statistical Area)",2016,53908,257300,3182,260482,254118,11722028,217447,105.8,98.7,125.9,102.8,109.5
1199,15680,"California-Lexington Park, MD (Metropolitan Statistical Area)",2016,53437,295900,5444,301344,290456,5971637,111750,100.9,92.1,122,94.4,104.4
1200,15940,"Canton-Massillon, OH (Metropolitan Statistical Area)",2016,41410,123200,1026,124226,122174,16608410,401068,87.4,96.1,64.7,91.6,90.5
1201,15980,"Cape Coral-Fort Myers, FL (Metropolitan Statistical Area)",2016,48098,171100,1892,172992,169208,34758296,722649,96.1,97.5,96,94.6,99.5
1202,16020,"Cape Girardeau, MO-IL (Metropolitan Statistical Area)",2016,40407,133400,3754,137154,129646,3923914,97109,83.1,93.6,63.7,90.6,86
1203,16060,"Carbondale-Marion, IL (Metropolitan Statistical Area)",2016,37896,104900,3141,108041,101759,5253618,138634,84.7,94.4,65.3,89.9,87.6
1204,16180,"Carson City, NV (Metropolitan Statistical Area)",2016,45771,199500,8525,208025,190975,2478381,54147,95.3,98.9,91.4,93.7,98.6
1205,16220,"Casper, WY (Metropolitan Statistical Area)",2016,63613,193200,3548,196748,189652,5146901,80909,96,93.6,94.9,100,99.4
1206,16300,"Cedar Rapids, IA (Metropolitan Statistical Area)",2016,49102,147300,1792,149092,145508,13170249,268224,88.4,95.2,69.3,92.2,91.5
1207,16540,"Chambersburg-Waynesboro, PA (Metropolitan Statistical Area)",2016,42576,174400,2623,177023,171777,6544207,153705,94.2,98.6,77.5,100,97.5
1208,16580,"Champaign-Urbana, IL (Metropolitan Statistical Area)",2016,43755,145100,2211,147311,142889,9920222,226722,93,96,89.9,91.5,96.3
1209,16620,"Charleston, WV (Metropolitan Statistical Area)",2016,40103,101800,2405,104205,99395,10752916,268130,87,95.7,60.1,94.7,90
1210,16700,"Charleston-North Charleston, SC (Metropolitan Statistical Area)",2016,46625,195700,2148,197848,193552,35508365,761578,96.4,97.5,97.3,94.6,99.8
1211,16740,"Charlotte-Concord-Gastonia, NC-SC (Metropolitan Statistical Area)",2016,48005,170400,861,171261,169539,119997339,2499697,93.6,97,85.8,94.6,96.9
1212,16820,"Charlottesville, VA (Metropolitan Statistical Area) *",2016,59765,264800,4149,268949,260651,12770227,213675,98.8,97.2,110.5,94.6,102.2
1213,16860,"Chattanooga, TN-GA (Metropolitan Statistical Area)",2016,42727,149700,1533,151233,148167,23579212,551859,88.5,97.1,70.6,91.9,91.6
1214,16940,"Cheyenne, WY (Metropolitan Statistical Area)",2016,48178,195900,4498,200398,191402,4715999,97887,95.9,93.6,94.3,100,99.2
1215,16980,"Chicago-Naperville-Elgin, IL-IN-WI (Metropolitan Statistical Area)",2016,56231,216000,633,216633,215367,536083043,9533662,103.5,99.7,114.5,101.9,107.1
1216,17020,"Chico, CA (Metropolitan Statistical Area)",2016,42362,228500,3731,232231,224769,9583705,226231,99.2,96.4,101.3,101.6,102.7
1217,17140,"Cincinnati, OH-KY-IN (Metropolitan Statistical Area)",2016,49900,156100,773,156873,155327,109360391,2191572,90,95.5,78.4,91,93.2
1218,17300,"Clarksville, TN-KY (Metropolitan Statistical Area)",2016,38782,139700,2350,142050,137350,11390730,293712,89.4,97,76.1,91.9,92.6
1219,17420,"Cleveland, TN (Metropolitan Statistical Area)",2016,36597,141100,3565,144665,137535,4435017,121184,83.2,91.9,66.2,91.4,86.1
1220,17460,"Cleveland-Elyria, OH (Metropolitan Statistical Area)",2016,49796,140200,721,140921,139479,102628391,2060997,90.4,95.8,77.7,91.8,93.6
1221,17660,"Coeur d'Alene, ID (Metropolitan Statistical Area)",2016,41386,193300,4055,197355,189245,6332789,153019,93.6,98.9,85.5,93.7,96.9
1222,17780,"College Station-Bryan, TX (Metropolitan Statistical Area)",2016,36265,154200,3331,157531,150869,9225417,254391,92.7,96.8,87.1,92.6,96
1223,17820,"Colorado Springs, CO (Metropolitan Statistical Area)",2016,45198,227800,1857,229657,225943,32196056,712335,98.1,93.8,104.4,99.8,101.5
1224,17860,"Columbia, MO (Metropolitan Statistical Area)",2016,43534,171400,3375,174775,168025,8883092,204049,89.7,95.3,75.4,92.2,92.9
1225,17900,"Columbia, SC (Metropolitan Statistical Area)",2016,42132,143000,1265,144265,141735,34429439,817188,92,97,80.2,94.6,95.2
1226,17980,"Columbus, GA-AL (Metropolitan Statistical Area)",2016,38237,139300,3173,142473,136127,12199027,319040,89.3,97,71.6,94.6,92.5
1227,18020,"Columbus, IN (Metropolitan Statistical Area)",2016,46180,137500,3792,141292,133708,3797404,82231,89.1,94.4,80.5,89.8,92.2
1228,18140,"Columbus, OH (Metropolitan Statistical Area)",2016,48153,161700,708,162408,160992,98819257,2052192,91.9,96,84,91.5,95.1
1229,18580,"Corpus Christi, TX (Metropolitan Statistical Area)",2016,40439,115300,1852,117152,113448,17346555,428953,93,97.4,86.5,92.6,96.3
1230,18700,"Corvallis, OR (Metropolitan Statistical Area)",2016,43534,276900,5103,282003,271797,3914457,89918,101.9,101.8,110.6,95.7,105.4
1231,18880,"Crestview-Fort Walton Beach-Destin, FL (Metropolitan Statistical Area)",2016,48184,190500,4282,194782,186218,12792419,265492,95.1,94.8,96.4,94.8,98.4
1232,19060,"Cumberland, MD-WV (Metropolitan Statistical Area)",2016,37612,121100,3609,124709,117491,3739705,99428,88.3,97.5,66.5,94.6,91.3
1233,19100,"Dallas-Fort Worth-Arlington, TX (Metropolitan Statistical Area)",2016,51428,163900,578,164478,163322,370009351,7194758,99.7,99.1,103,98.4,103.1
1234,19140,"Dalton, GA (Metropolitan Statistical Area)",2016,33961,113300,3398,116698,109902,4881924,143753,84.2,92.1,65.7,94.3,87.1
1235,19180,"Danville, IL (Metropolitan Statistical Area)",2016,36476,75800,1809,77609,73991,2863146,78494,80.6,94.4,57.1,89.8,83.5
1236,19300,"Daphne-Fairhope-Foley, AL (Metropolitan Statistical Area)",2016,43143,173400,3862,177262,169538,8956578,207601,90.5,97.3,81,91.9,93.7
1237,19340,"Davenport-Moline-Rock Island, IA-IL (Metropolitan Statistical Area)",2016,45994,127600,1665,129265,125935,17577885,382178,88.9,95.4,71.9,92.3,92.1
1238,19460,"Decatur, AL (Metropolitan Statistical Area)",2016,36060,117900,2833,120733,115067,5489572,152233,83.5,97.4,52.9,91.9,86.4
1239,19500,"Decatur, IL (Metropolitan Statistical Area)",2016,45196,95700,2458,98158,93242,4808075,106383,85,96.1,57.7,91.6,88
1240,19660,"Deltona-Daytona Beach-Ormond Beach, FL (Metropolitan Statistical Area)",2016,39910,147000,1759,148759,145241,25377335,635859,95.6,97.5,93.9,94.6,98.9
1241,19740,"Denver-Aurora-Lakewood, CO (Metropolitan Statistical Area) *",2016,56789,287400,954,288354,286446,162232980,2856755,104.5,98.8,127.6,97,108.1
1242,19780,"Des Moines-West Des Moines, IA (Metropolitan Statistical Area)",2016,50940,164500,1159,165659,163341,34183500,671055,93,95.3,89.3,92.3,96.3
1243,19820,"Detroit-Warren-Dearborn, MI (Metropolitan Statistical Area)",2016,49028,137200,662,137862,136538,211618011,4316260,95.5,98.5,86.5,97.7,98.9
1244,20020,"Dothan, AL (Metropolitan Statistical Area)",2016,38621,111500,2217,113717,109283,5707566,147784,83.6,96.3,56.9,91.8,86.5
1245,20100,"Dover, DE (Metropolitan Statistical Area)",2016,39150,199800,3342,203142,196458,6833378,174542,94.6,97.5,89.9,94.6,97.9
1246,20220,"Dubuque, IA (Metropolitan Statistical Area)",2016,45373,153000,2628,155628,150372,4390384,96763,90.6,95.4,77.5,92.4,93.7
1247,20260,"Duluth, MN-WI (Metropolitan Statistical Area)",2016,42281,144900,2014,146914,142886,12235956,289395,89.4,95.2,75.5,92.2,92.5
1248,20500,"Durham-Chapel Hill, NC (Metropolitan Statistical Area)",2016,49248,203400,3412,206812,199988,30446265,618222,94.7,96.4,90.7,94.7,98
1249,20700,"East Stroudsburg, PA (Metropolitan Statistical Area)",2016,39641,170600,2519,173119,168081,6589053,166220,97.2,98.6,90.8,100,100.6
1250,20740,"Eau Claire, WI (Metropolitan Statistical Area)",2016,43246,152900,1923,154823,150977,7197451,166430,90,96.1,76.1,91.6,93.2
1251,20940,"El Centro, CA (Metropolitan Statistical Area)",2016,36493,159000,3067,162067,155933,6575270,180179,90.7,101.8,71.4,95.7,93.9
1252,21060,"Elizabethtown-Fort Knox, KY (Metropolitan Statistical Area)",2016,39705,140900,2827,143727,138073,5913731,148941,85.1,91.9,72.4,91.4,88.1
1253,21140,"Elkhart-Goshen, IN (Metropolitan Statistical Area)",2016,41963,125300,2387,127687,122913,8545400,203642,89.3,96.1,72.5,91.6,92.4
1254,21300,"Elmira, NY (Metropolitan Statistical Area)",2016,40709,101800,3028,104828,98772,3486483,85644,95.1,98.6,82.2,100,98.5
1255,21340,"El Paso, TX (Metropolitan Statistical Area)",2016,33481,114500,905,115405,113595,28097282,839203,88.2,97.3,72,92.6,91.2
1256,21420,"Enid, OK (Metropolitan Statistical Area)",2016,43605,100800,3951,104751,96849,2725012,62493,89.7,97.4,72.8,92.6,92.8
1257,21500,"Erie, PA (Metropolitan Statistical Area)",2016,41394,120300,1735,122035,118565,11431703,276170,92.8,98.6,73.2,100,96.1
1258,21660,"Eugene-Springfield, OR (Metropolitan Statistical Area)",2016,42396,221000,2536,223536,218464,15638663,368874,98,96.4,96.3,101.6,101.5
1259,21780,"Evansville, IN-KY (Metropolitan Statistical Area)",2016,43777,127600,1937,129537,125663,13802168,315283,88.3,96.1,68.1,91.6,91.4
1260,21820,"Fairbanks, AK (Metropolitan Statistical Area) *",2016,53051,224000,6721,230721,217279,5338649,100633,107.8,101,147.3,95.4,111.6
1261,22020,"Fargo, ND-MN (Metropolitan Statistical Area)",2016,50008,176900,2635,179535,174265,11864177,237244,91.4,95.4,81.9,92.4,94.6
1262,22140,"Farmington, NM (Metropolitan Statistical Area)",2016,33268,142500,5013,147513,137487,4256764,127954,90.6,98.9,73.1,93.7,93.8
1263,22180,"Fayetteville, NC (Metropolitan Statistical Area)",2016,34538,129700,2283,131983,127417,17849753,516822,89.2,96,75.7,94.6,92.3
1264,22220,"Fayetteville-Springdale-Rogers, AR (Metropolitan Statistical Area)",2016,60800,151800,1771,153571,150029,30631396,503806,89.3,97.3,70.6,92.6,92.4
1265,22380,"Flagstaff, AZ (Metropolitan Statistical Area)",2016,44465,231300,7206,238506,224094,6243199,140407,97.6,98.9,100.8,93.7,101
1266,22420,"Flint, MI (Metropolitan Statistical Area)",2016,38215,91800,1535,93335,90265,15627147,408926,89.9,98.3,66.7,96.9,93.1
1267,22500,"Florence, SC (Metropolitan Statistical Area)",2016,37592,110700,2998,113698,107702,7738544,205854,85.7,96.2,60,94.6,88.7
1268,22520,"Florence-Muscle Shoals, AL (Metropolitan Statistical Area)",2016,35878,117000,3229,120229,113771,5271266,146922,83.4,97.4,52,91.9,86.3
1269,22540,"Fond du Lac, WI (Metropolitan Statistical Area)",2016,44261,147000,2219,149219,144781,4523940,102211,87.6,94.4,74.8,89.8,90.7
1270,22660,"Fort Collins, CO (Metropolitan Statistical Area)",2016,48422,282500,3359,285859,279141,16414294,338984,100.5,93.6,117.3,100,104
1271,22900,"Fort Smith, AR-OK (Metropolitan Statistical Area)",2016,35687,104000,1638,105638,102362,8892102,249170,84.9,97.1,58,92.6,87.9
1272,23060,"Fort Wayne, IN (Metropolitan Statistical Area)",2016,43098,117700,1106,118806,116594,17363542,402887,88.9,96.1,70.4,91.6,92
1273,23420,"Fresno, CA (Metropolitan Statistical Area)",2016,41122,204900,2389,207289,202511,40168751,976830,96.6,96.4,89.8,101.6,100
1274,23460,"Gadsden, AL (Metropolitan Statistical Area)",2016,35070,101900,3604,105504,98296,3607098,102855,82.7,97.4,51.3,91.9,85.6
1275,23540,"Gainesville, FL (Metropolitan Statistical Area)",2016,39446,160400,2593,162993,157807,12678659,321418,93.8,96,88.5,94.7,97.1
1276,23580,"Gainesville, GA (Metropolitan Statistical Area)",2016,40172,164500,2516,167016,161984,7880145,196159,89.3,92.1,80.8,94.3,92.4
1277,23900,"Gettysburg, PA (Metropolitan Statistical Area)",2016,45347,194800,3275,198075,191525,4621403,101911,96.1,98.6,85.6,100,99.4
1278,24020,"Glens Falls, NY (Metropolitan Statistical Area)",2016,42590,166400,2494,168894,163906,5376306,126233,96.4,98.6,87,100,99.8
1279,24140,"Goldsboro, NC (Metropolitan Statistical Area)",2016,35636,114200,3848,118048,110352,4428393,124269,87.1,97.5,63.1,94.6,90.1
1280,24220,"Grand Forks, ND-MN (Metropolitan Statistical Area)",2016,46787,160900,2547,163447,158353,4780299,102171,92,95.4,85,92.4,95.2
1281,24260,"Grand Island, NE (Metropolitan Statistical Area)",2016,41755,121800,2804,124604,118996,3156570,75598,85.6,93.6,67.8,90.6,88.6
1282,24300,"Grand Junction, CO (Metropolitan Statistical Area)",2016,40462,201500,4493,205993,197007,6058618,149736,93.7,98.9,86.1,93.7,96.9
1283,24340,"Grand Rapids-Kentwood, MI (Metropolitan Statistical Area)",2016,46661,146300,1031,147331,145269,49213869,1054710,92.3,95.9,86,91.4,95.6
1284,24420,"Grants Pass, OR (Metropolitan Statistical Area)",2016,37828,225100,7261,232361,217839,3234439,85504,94.8,101.8,84,95.7,98.1
1285,24500,"Great Falls, MT (Metropolitan Statistical Area)",2016,44272,165800,2566,168366,163234,3610915,81562,91.3,93.6,75,100,94.5
1286,24540,"Greeley, CO (Metropolitan Statistical Area) *",2016,43745,227100,3039,230139,224061,12935823,295712,97.4,97.9,95.8,98.1,100.8
1287,24580,"Green Bay, WI (Metropolitan Statistical Area)",2016,47413,159100,1233,160333,157867,15047266,317369,90.1,95.9,76.6,91.3,93.3
1288,24660,"Greensboro-High Point, NC (Metropolitan Statistical Area)",2016,40720,140900,1419,142319,139481,30891476,758635,90.1,97.1,72.4,94.6,93.3
1289,24780,"Greenville, NC (Metropolitan Statistical Area)",2016,38565,135000,3276,138276,131724,6832669,177171,87.9,97.5,67.6,94.6,91
1290,24860,"Greenville-Anderson, SC (Metropolitan Statistical Area)",2016,41049,143700,1293,144993,142407,36301109,884327,89.8,97.3,71.9,94.6,93
1291,25060,"Gulfport-Biloxi, MS (Metropolitan Statistical Area)",2016,35363,130400,2701,133101,127699,14458594,408865,88.3,97.2,71.9,91.9,91.4
1292,25180,"Hagerstown-Martinsburg, MD-WV (Metropolitan Statistical Area)",2016,41204,180200,3535,183735,176665,11566734,280717,98.1,101.6,81.8,107.7,101.6
1293,25220,"Hammond, LA (Metropolitan Statistical Area)",2016,36008,143300,6435,149735,136865,4703305,130619,85,91.9,71.3,92.1,88
1294,25260,"Hanford-Corcoran, CA (Metropolitan Statistical Area)",2016,35230,172000,3662,175662,168338,5262778,149382,95.5,101.8,85.7,95.7,98.8
1295,25420,"Harrisburg-Carlisle, PA (Metropolitan Statistical Area)",2016,48348,173200,1234,174434,171966,27437861,567510,96.6,98.6,87.4,100,100
1296,25500,"Harrisonburg, VA (Metropolitan Statistical Area) *",2016,37255,199700,4131,203831,195569,4951531,132909,89.2,92.1,81.3,94.3,92.3
1297,25540,"Hartford-East Hartford-Middletown, CT (Metropolitan Statistical Area)",2016,60050,244000,1399,245399,242601,72576163,1208595,102.4,98.8,109,102.9,106
1298,25620,"Hattiesburg, MS (Metropolitan Statistical Area)",2016,36251,133900,4475,138375,129425,6095881,168158,82.5,91.8,63,91.6,85.4
1299,25860,"Hickory-Lenoir-Morganton, NC (Metropolitan Statistical Area)",2016,36649,123000,1931,124931,121069,13369420,364798,87.2,97.5,60.9,94.6,90.2
1300,25940,"Hilton Head Island-Bluffton, SC (Metropolitan Statistical Area)",2016,49310,253500,6854,260354,246646,10417593,211269,95.2,92.1,99.7,94.4,98.5
1301,25980,"Hinesville, GA (Metropolitan Statistical Area)",2016,31532,120000,4609,124609,115391,2517702,79845,90.8,92.2,87,94.4,94
1302,26140,"Homosassa Springs, FL (Metropolitan Statistical Area)",2016,36082,114300,3387,117687,110913,5152720,142804,88,92.1,79.2,94.4,91.1
1303,26300,"Hot Springs, AR (Metropolitan Statistical Area)",2016,37412,133700,4676,138376,129024,3676878,98282,84.9,91.9,71.3,92.1,87.9
1304,26380,"Houma-Thibodaux, LA (Metropolitan Statistical Area)",2016,40777,138800,3909,142709,134891,8624875,211512,90.2,97.4,75.1,92.6,93.4
1305,26420,"Houston-The Woodlands-Sugar Land, TX (Metropolitan Statistical Area)",2016,50812,157400,668,158068,156732,345851800,6806503,101.3,95.7,102.9,107.4,104.9
1306,26580,"Huntington-Ashland, WV-KY-OH (Metropolitan Statistical Area)",2016,36636,108000,1666,109666,106334,13372859,365020,86.4,96.8,58.6,94.5,89.5
1307,26620,"Huntsville, AL (Metropolitan Statistical Area)",2016,46374,165600,1597,167197,164003,20848744,449576,88.7,97.4,68.1,91.9,91.8
1308,26820,"Idaho Falls, ID (Metropolitan Statistical Area)",2016,41911,156500,2340,158840,154160,5973154,142520,89.6,98.9,70.3,93.6,92.7
1309,26900,"Indianapolis-Carmel-Anderson, IN (Metropolitan Statistical Area)",2016,50809,144700,812,145512,143888,101961247,2006760,91.6,96.1,82.8,91.5,94.8
1310,26980,"Iowa City, IA (Metropolitan Statistical Area)",2016,49461,190700,3313,194013,187387,8361565,169054,94.6,95.3,97.4,92.2,97.9
1311,27060,"Ithaca, NY (Metropolitan Statistical Area)",2016,41111,182600,4194,186794,178406,4232087,102942,106.5,98.6,135.2,100,110.2
1312,27100,"Jackson, MI (Metropolitan Statistical Area)",2016,37112,115700,2516,118216,113184,5873902,158277,88.5,96.1,69.9,91.6,91.6
1313,27140,"Jackson, MS (Metropolitan Statistical Area)",2016,41618,135900,1979,137879,133921,24936133,599170,88.9,96.8,72.4,91.9,92.1
1314,27180,"Jackson, TN (Metropolitan Statistical Area)",2016,37582,117500,2751,120251,114749,6701139,178306,80.7,91.8,58,91.6,83.5
1315,27260,"Jacksonville, FL (Metropolitan Statistical Area)",2016,45818,163700,1215,164915,162485,67629055,1476023,96,97.4,95.5,94.6,99.3
1316,27340,"Jacksonville, NC (Metropolitan Statistical Area)",2016,45896,153300,2869,156169,150431,8826368,192314,92.8,97.5,84.9,94.6,96.1
1317,27500,"Janesville-Beloit, WI (Metropolitan Statistical Area)",2016,41038,132500,1792,134292,130708,6620301,161320,90.5,96.1,78.1,91.6,93.7
1318,27620,"Jefferson City, MO (Metropolitan Statistical Area)",2016,40205,140500,2736,143236,137764,6086094,151375,82.7,93.6,58.9,90.6,85.6
1319,27740,"Johnson City, TN (Metropolitan Statistical Area)",2016,37408,134100,2412,136512,131688,7536185,201457,87.3,97.4,65.5,91.9,90.3
1320,27780,"Johnstown, PA (Metropolitan Statistical Area)",2016,39810,88200,1514,89714,86686,5350984,134414,86.7,98.6,52.3,100,89.7
1321,27860,"Jonesboro, AR (Metropolitan Statistical Area)",2016,34715,116600,3503,120103,113097,4509738,129906,81.6,91.9,62.3,92.1,84.4
1322,27900,"Joplin, MO (Metropolitan Statistical Area)",2016,37435,110100,2138,112238,107962,6640774,177397,86.9,95.4,63.1,92.4,89.9
1323,27980,"Kahului-Wailuku-Lahaina, HI (Metropolitan Statistical Area)",2016,45434,528500,13724,542224,514776,7516459,165438,109.3,103.3,137.9,96.6,113.1
1324,28020,"Kalamazoo-Portage, MI (Metropolitan Statistical Area)",2016,45128,136800,1729,138529,135071,11792105,261304,90.5,96.1,78.5,91.6,93.7
1325,28100,"Kankakee, IL (Metropolitan Statistical Area)",2016,38287,138900,2981,141881,135919,4252965,111080,95.1,98.6,81,100.5,98.5
1326,28140,"Kansas City, MO-KS (Metropolitan Statistical Area)",2016,50056,162400,741,163141,161659,105471309,2107066,93,96,82.2,95.9,96.2
1327,28420,"Kennewick-Richland, WA (Metropolitan Statistical Area)",2016,42233,182700,2333,185033,180367,11981235,283693,97.3,96.4,92.5,101.6,100.7
1328,28660,"Killeen-Temple, TX (Metropolitan Statistical Area)",2016,39634,126500,2299,128799,124201,17297242,436421,91,97.2,80,92.6,94.2
1329,28700,"Kingsport-Bristol, TN-VA (Metropolitan Statistical Area) *",2016,37064,120200,1859,122059,118341,11342320,306017,84.7,97.4,56.7,92.5,87.7
1330,28740,"Kingston, NY (Metropolitan Statistical Area)",2016,46296,219800,3469,223269,216331,8288975,179042,103.6,98.6,120.4,100,107.3
1331,28940,"Knoxville, TN (Metropolitan Statistical Area)",2016,42635,154800,1292,156092,153508,36023801,844942,88.1,96.7,68.6,91.9,91.2
1332,29020,"Kokomo, IN (Metropolitan Statistical Area)",2016,38977,97900,2657,100557,95243,3207938,82304,84.8,96.1,57.5,91.6,87.8
1333,29100,"La Crosse-Onalaska, WI-MN (Metropolitan Statistical Area)",2016,46479,159300,1837,161137,157463,6338993,136384,91.9,96.1,84.2,91.6,95.1
1334,29180,"Lafayette, LA (Metropolitan Statistical Area)",2016,40388,135500,2887,138387,132613,19825350,490877,87.9,96.4,69.2,92.6,91
1335,29200,"Lafayette-West Lafayette, IN (Metropolitan Statistical Area)",2016,36251,133000,2863,135863,130137,8232065,227088,91.1,95.8,81.7,91.3,94.3
1336,29340,"Lake Charles, LA (Metropolitan Statistical Area)",2016,44414,125100,3388,128488,121712,9214310,207464,87.5,97.2,66.5,92.6,90.6
1337,29420,"Lake Havasu City-Kingman, AZ (Metropolitan Statistical Area)",2016,30370,130000,4639,134639,125361,6238434,205412,90.5,93.6,73.7,100,93.7
1338,29460,"Lakeland-Winter Haven, FL (Metropolitan Statistical Area)",2016,33561,110400,1646,112046,108754,22346001,665823,93.1,97.5,84.7,94.6,96.4
1339,29540,"Lancaster, PA (Metropolitan Statistical Area)",2016,47880,191400,1554,192954,189846,25767174,538160,99.4,98.6,99.7,100,102.9
1340,29620,"Lansing-East Lansing, MI (Metropolitan Statistical Area)",2016,38621,133000,1386,134386,131614,21054114,545146,91.3,95.9,82.1,91.4,94.5
1341,29700,"Laredo, TX (Metropolitan Statistical Area)",2016,29539,110500,2268,112768,108232,8043545,272301,88.7,97.4,71.9,92.6,91.8
1342,29740,"Las Cruces, NM (Metropolitan Statistical Area)",2016,34578,137300,4488,141788,132812,7422695,214663,89.8,93.6,71.4,100,92.9
1343,29820,"Las Vegas-Henderson-Paradise, NV (Metropolitan Statistical Area)",2016,43950,186700,1647,188347,185053,94001080,2138836,96.3,93.6,96.2,100,99.7
1344,29940,"Lawrence, KS (Metropolitan Statistical Area)",2016,40024,181900,3509,185409,178391,4789302,119662,91.6,95.4,83.2,92.4,94.8
1345,30020,"Lawton, OK (Metropolitan Statistical Area)",2016,39008,115900,3044,118944,112856,4980435,127676,89.3,96.8,72.6,92.7,92.4
1346,30140,"Lebanon, PA (Metropolitan Statistical Area)",2016,44212,164900,1953,166853,162947,6122493,138480,95.5,98.6,83.1,100,98.9
1347,30300,"Lewiston, ID-WA (Metropolitan Statistical Area)",2016,41974,171700,4138,175838,167562,2620074,62422,90.5,98.9,73,93.7,93.7
1348,30340,"Lewiston-Auburn, ME (Metropolitan Statistical Area)",2016,38459,152100,2464,154564,149636,4126462,107296,95.3,98.7,79.5,102.8,98.7
1349,30460,"Lexington-Fayette, KY (Metropolitan Statistical Area)",2016,45125,166700,1283,167983,165417,22896007,507387,90.5,97.4,76.1,91.9,93.7
1350,30620,"Lima, OH (Metropolitan Statistical Area)",2016,39336,107500,2338,109838,105162,4075760,103613,86.2,96.1,60.9,91.6,89.2
1351,30700,"Lincoln, NE (Metropolitan Statistical Area)",2016,45670,156800,1306,158106,155494,14952753,327409,91.3,95.4,81.3,92.3,94.5
1352,30780,"Little Rock-North Little Rock-Conway, AR (Metropolitan Statistical Area)",2016,43142,141700,1737,143437,139963,31673523,734166,90,97.2,73.9,92.6,93.1
1353,30860,"Logan, UT-ID (Metropolitan Statistical Area)",2016,35432,194500,3503,198003,190997,4801766,135521,90.5,98.9,74.2,93.7,93.7
1354,30980,"Longview, TX (Metropolitan Statistical Area)",2016,39297,114900,2993,117893,111907,11146264,283641,90.2,96.6,76.3,92.6,93.4
1355,31020,"Longview, WA (Metropolitan Statistical Area)",2016,41589,180000,4030,184030,175970,4355998,104740,95.7,101.8,86.3,95.7,99.1
1356,31080,"Los Angeles-Long Beach-Anaheim, CA (Metropolitan Statistical Area)",2016,58945,493900,1156,495056,492744,782242474,13270694,116.7,105.1,165,104.8,120.8
1357,31140,"Louisville/Jefferson County, KY-IN (Metropolitan Statistical Area)",2016,46610,151800,943,152743,150857,58379717,1252525,90.3,97.1,75.8,91.8,93.4
1358,31180,"Lubbock, TX (Metropolitan Statistical Area)",2016,39734,114400,1836,116236,112564,12467654,313780,92.7,97.1,85.3,92.6,95.9
1359,31340,"Lynchburg, VA (Metropolitan Statistical Area) *",2016,37738,163300,1872,165172,161428,9832249,260537,90.2,97.3,72.4,94.6,93.3
1360,31420,"Macon-Bibb County, GA (Metropolitan Statistical Area)",2016,38171,119200,3176,122376,116024,8746728,229148,86.3,96.7,61.7,94.6,89.3
1361,31460,"Madera, CA (Metropolitan Statistical Area)",2016,37231,204800,7402,212202,197398,5731880,153956,95,96.4,84,101.6,98.4
1362,31540,"Madison, WI (Metropolitan Statistical Area)",2016,54645,224200,1410,225610,222790,35431163,648388,96.5,95.9,108.3,91.4,99.9
1363,31700,"Manchester-Nashua, NH (Metropolitan Statistical Area)",2016,56615,248500,2060,250560,246440,23287695,411333,108.9,102.1,125.7,107.1,112.7
1364,31740,"Manhattan, KS (Metropolitan Statistical Area)",2016,43008,178100,5098,183198,173002,5763056,134000,92.6,93.6,93.2,90.6,95.8
1365,31860,"Mankato, MN (Metropolitan Statistical Area)",2016,43153,169600,2271,171871,167329,4318545,100075,90.6,93.6,86.3,90.6,93.7
1366,31900,"Mansfield, OH (Metropolitan Statistical Area)",2016,36551,102600,2640,105240,99960,4431478,121242,85.7,96.1,59.3,91.6,88.7
1367,32580,"McAllen-Edinburg-Mission, TX (Metropolitan Statistical Area)",2016,25290,81400,1136,82536,80264,21470472,848960,83.9,97.4,58,92.6,86.8
1368,32780,"Medford, OR (Metropolitan Statistical Area)",2016,43217,224500,4431,228931,220069,9264181,214366,97.8,96.4,95.4,101.6,101.3
1369,32820,"Memphis, TN-MS-AR (Metropolitan Statistical Area)",2016,43525,134900,1269,136169,133631,58158688,1336204,90.3,97.2,76.6,91.9,93.4
1370,32900,"Merced, CA (Metropolitan Statistical Area)",2016,37345,171800,3249,175049,168551,9994614,267628,94.4,96.4,81.2,101.6,97.7
1371,33100,"Miami-Fort Lauderdale-Pompano Beach, FL (Metropolitan Statistical Area)",2016,51682,215700,1217,216917,214483,312972537,6055686,109.3,102.4,129.1,103.4,113.1
1372,33140,"Michigan City-La Porte, IN (Metropolitan Statistical Area)",2016,39156,123700,3344,127044,120356,4315852,110222,86.2,94.4,70.9,89.8,89.2
1373,33220,"Midland, MI (Metropolitan Statistical Area)",2016,46702,131100,3635,134735,127465,3895971,83422,90.7,96.1,78.2,91.6,93.9
1374,33260,"Midland, TX (Metropolitan Statistical Area)",2016,75295,173700,4344,178044,169356,12760015,169466,100.4,97,129.8,92.6,103.9
1375,33340,"Milwaukee-Waukesha, WI (Metropolitan Statistical Area)",2016,52535,194400,1049,195449,193351,82794744,1576004,95.5,96.2,94.9,95.1,98.9
1376,33460,"Minneapolis-St. Paul-Bloomington, MN-WI (Metropolitan Statistical Area)",2016,58194,220700,643,221343,220057,205922804,3538527,102.5,105.1,109.9,96.1,106.1
1377,33540,"Missoula, MT (Metropolitan Statistical Area)",2016,45022,243700,3941,247641,239759,5238224,116349,95.5,98.9,92.3,93.7,98.8
1378,33660,"Mobile, AL (Metropolitan Statistical Area)",2016,36330,123500,1843,125343,121657,15678818,431566,86.8,96.9,64.8,91.9,89.8
1379,33700,"Modesto, CA (Metropolitan Statistical Area)",2016,41604,216000,2921,218921,213079,22435251,539255,98.1,96.4,96.3,101.6,101.5
1380,33740,"Monroe, LA (Metropolitan Statistical Area)",2016,37939,122600,3514,126114,119086,7789545,205319,83.1,96.5,55.2,92.6,86.1
1381,33780,"Monroe, MI (Metropolitan Statistical Area)",2016,43492,141500,2691,144191,138809,6487185,149159,93.3,98.3,79,96.9,96.6
1382,33860,"Montgomery, AL (Metropolitan Statistical Area)",2016,40869,130200,2161,132361,128039,15279590,373865,88.3,97.3,69.7,91.9,91.4
1383,34060,"Morgantown, WV (Metropolitan Statistical Area)",2016,39140,151500,3421,154921,148079,5456276,139403,92.1,92.1,89.7,94.3,95.3
1384,34100,"Morristown, TN (Metropolitan Statistical Area)",2016,33843,127800,3660,131460,124140,4735435,139924,79.8,91.9,58.7,91.4,82.6
1385,34580,"Mount Vernon-Anacortes, WA (Metropolitan Statistical Area)",2016,47447,255100,4577,259677,250523,5864530,123603,99.4,101.8,100.5,95.7,102.9
1386,34620,"Muncie, IN (Metropolitan Statistical Area)",2016,34563,87800,1747,89547,86053,3997455,115657,86.1,96.1,63.9,91.6,89.1
1387,34740,"Muskegon, MI (Metropolitan Statistical Area)",2016,36024,101400,2026,103426,99374,6240268,173227,86.5,96.1,63.7,91.6,89.5
1388,34820,"Myrtle Beach-Conway-North Myrtle Beach, SC-NC (Metropolitan Statistical Area)",2016,36702,167900,1559,169459,166341,16418302,447337,91.5,96.2,83.8,94.6,94.7
1389,34900,"Napa, CA (Metropolitan Statistical Area)",2016,68426,503100,12286,515386,490814,9637180,140840,122.7,110.6,163.5,112.4,127
1390,34940,"Naples-Marco Island, FL (Metropolitan Statistical Area)",2016,85274,291900,5878,297778,286022,31162883,365445,101.3,97.5,123.7,94.6,104.9
1391,34980,"Nashville-Davidson--Murfreesboro--Franklin, TN (Metropolitan Statistical Area)",2016,53648,183400,1264,184664,182136,98782316,1841294,93.6,97.1,90.3,91.9,96.9
1392,35100,"New Bern, NC (Metropolitan Statistical Area)",2016,41104,148700,3594,152294,145106,5137343,124985,86.3,92.1,73.4,94.3,89.3
1393,35300,"New Haven-Milford, CT (Metropolitan Statistical Area)",2016,52695,244000,1800,245800,242200,45206790,857901,108.9,105.3,113.4,109.8,112.7
1394,35380,"New Orleans-Metairie, LA (Metropolitan Statistical Area)",2016,48132,179500,1587,181087,177913,61012409,1267613,94.7,97.2,93.6,92.6,98
1395,35620,"New York-Newark-Jersey City, NY-NJ-PA (Metropolitan Statistical Area)",2016,68703,403300,877,404177,402423,1328347854,19334778,123.6,109.4,155,120.5,128
1396,35660,"Niles, MI (Metropolitan Statistical Area)",2016,44049,137000,2567,139567,134433,6797871,154325,87.9,96.1,67.9,91.6,91
1397,35840,"North Port-Sarasota-Bradenton, FL (Metropolitan Statistical Area)",2016,52435,189400,2266,191666,187134,41336408,788341,99.3,97.5,109.9,94.6,102.8
1398,35980,"Norwich-New London, CT (Metropolitan Statistical Area)",2016,55010,241500,3065,244565,238435,14764966,268403,102,98.7,107.2,102.8,105.6
1399,36100,"Ocala, FL (Metropolitan Statistical Area)",2016,34775,114400,2541,116941,111859,12083101,347469,90.4,97.5,75.5,94.6,93.6
1400,36140,"Ocean City, NJ (Metropolitan Statistical Area)",2016,56059,296100,5720,301820,290380,5250224,93655,104.4,100.9,110.7,104,108.1
1401,36220,"Odessa, TX (Metropolitan Statistical Area)",2016,37802,112300,3252,115552,109048,5967285,157858,96.3,97.4,101,92.6,99.7
1402,36260,"Ogden-Clearfield, UT (Metropolitan Statistical Area)",2016,40429,206900,2039,208939,204861,26378976,652476,93.6,94.1,84.2,99.5,96.9
1403,36420,"Oklahoma City, OK (Metropolitan Statistical Area)",2016,44458,141500,880,142380,140620,61039624,1372985,91.1,97.1,78.1,92.6,94.3
1404,36500,"Olympia-Lacey-Tumwater, WA (Metropolitan Statistical Area)",2016,47109,242900,2654,245554,240246,12894517,273714,107.2,106.8,112.6,104.3,111
1405,36540,"Omaha-Council Bluffs, NE-IA (Metropolitan Statistical Area)",2016,52984,152100,1065,153165,151035,48927405,923431,92.3,95.4,85.7,92.3,95.5
1406,36740,"Orlando-Kissimmee-Sanford, FL (Metropolitan Statistical Area)",2016,40012,166300,988,167288,165312,98253100,2455583,98.2,97.5,104.4,94.6,101.6
1407,36780,"Oshkosh-Neenah, WI (Metropolitan Statistical Area)",2016,44687,144300,1871,146171,142429,7580226,169629,90.2,96.1,75.8,91.6,93.4
1408,36980,"Owensboro, KY (Metropolitan Statistical Area)",2016,38928,116400,2651,119051,113749,4597057,118092,86.5,96.8,62,91.9,89.5
1409,37100,"Oxnard-Thousand Oaks-Ventura, CA (Metropolitan Statistical Area)",2016,57270,481400,3706,485106,477694,48525841,847323,117.2,101.1,171.2,107.3,121.3
1410,37340,"Palm Bay-Melbourne-Titusville, FL (Metropolitan Statistical Area)",2016,42016,150500,1845,152345,148655,24237966,576874,95.8,97.5,94.7,94.6,99.1
1411,37460,"Panama City, FL (Metropolitan Statistical Area)",2016,41129,160500,3269,163769,157231,7552595,183634,94.4,97.5,90.1,94.6,97.7
1412,37620,"Parkersburg-Vienna, WV (Metropolitan Statistical Area)",2016,37899,106400,3434,109834,102966,3466858,91476,86.9,97.3,60.8,94.6,90
1413,37860,"Pensacola-Ferry Pass-Brent, FL (Metropolitan Statistical Area)",2016,40500,139000,2521,141521,136479,19495497,481367,92.5,97.5,82.6,94.6,95.8
1414,37900,"Peoria, IL (Metropolitan Statistical Area)",2016,45642,133300,1815,135115,131485,18747460,410754,89.2,95.9,72,91.4,92.3
1415,37980,"Philadelphia-Camden-Wilmington, PA-NJ-DE-MD (Metropolitan Statistical Area)",2016,60338,237700,553,238253,237147,366049754,6066661,105.4,100.6,111,107.5,109.1
1416,38060,"Phoenix-Mesa-Chandler, AZ (Metropolitan Statistical Area)",2016,42635,196400,979,197379,195421,199246775,4673336,97.4,95.4,97.5,99.7,100.8
1417,38220,"Pine Bluff, AR (Metropolitan Statistical Area)",2016,32370,79900,2562,82462,77338,2990385,92380,82.7,96.5,52,92.6,85.6
1418,38300,"Pittsburgh, PA (Metropolitan Statistical Area)",2016,51898,136700,696,137396,136004,121453934,2340222,93,98.7,78.7,94.1,96.3
1419,38340,"Pittsfield, MA (Metropolitan Statistical Area)",2016,52766,204200,5411,209611,198789,6704798,127067,97.2,98.7,86.6,102.8,100.6
1420,38540,"Pocatello, ID (Metropolitan Statistical Area)",2016,35304,146600,3195,149795,143405,3260613,92357,88.6,98.8,67.8,93.7,91.7
1421,38860,"Portland-South Portland, ME (Metropolitan Statistical Area)",2016,52474,238400,1710,240110,236690,27753985,528912,102.6,99,109,103.1,106.2
1422,38900,"Portland-Vancouver-Hillsboro, OR-WA (Metropolitan Statistical Area)",2016,51672,286800,1196,287996,285604,125385359,2426575,102.3,100.4,117.4,97.1,105.9
1423,38940,"Port St. Lucie, FL (Metropolitan Statistical Area)",2016,50784,155600,2685,158285,152915,23558381,463891,96.9,97.5,99.2,94.6,100.3
1424,39300,"Providence-Warwick, RI-MA (Metropolitan Statistical Area)",2016,50346,251400,1461,252861,249939,81300304,1614840,100.5,99.3,98,103.6,104.1
1425,39340,"Provo-Orem, UT (Metropolitan Statistical Area)",2016,37289,238100,1605,239705,236495,22422284,601304,95.3,93.7,91.6,99.9,98.6
1426,39380,"Pueblo, CO (Metropolitan Statistical Area)",2016,36125,142700,2679,145379,140021,5952463,164774,90.2,93.6,72.1,100,93.4
1427,39460,"Punta Gorda, FL (Metropolitan Statistical Area)",2016,39527,154400,3402,157802,150998,7022811,177671,94.8,97.5,91.4,94.6,98.1
1428,39540,"Racine, WI (Metropolitan Statistical Area)",2016,45203,163900,2340,166240,161560,8807713,194846,93.2,96.2,83.1,95.1,96.5
1429,39580,"Raleigh-Cary, NC (Metropolitan Statistical Area)",2016,51286,216600,1659,218259,214941,66869661,1303854,96.1,97.5,95.8,94.6,99.4
1430,39660,"Rapid City, SD (Metropolitan Statistical Area)",2016,46726,168100,2325,170425,165775,6375808,136450,90,95.2,77.8,92.1,93.2
1431,39740,"Reading, PA (Metropolitan Statistical Area)",2016,46142,169000,1488,170488,167512,19185253,415784,96.4,98.6,86.6,100,99.7
1432,39820,"Redding, CA (Metropolitan Statistical Area)",2016,43601,223500,3988,227488,219512,7785786,178571,97.7,96.4,94.8,101.6,101.1
1433,39900,"Reno, NV (Metropolitan Statistical Area)",2016,52787,236300,3257,239557,233043,23949879,453709,97.2,93.7,100.5,100,100.6
1434,40060,"Richmond, VA (Metropolitan Statistical Area) *",2016,53315,214500,1238,215738,213262,67095844,1258471,96.4,97.4,97.4,94.6,99.7
1435,40140,"Riverside-San Bernardino-Ontario, CA (Metropolitan Statistical Area)",2016,37924,267500,1406,268906,266094,171115495,4512041,106.4,99.4,117.2,107.2,110.2
1436,40220,"Roanoke, VA (Metropolitan Statistical Area) *",2016,44503,169400,1727,171127,167673,13913855,312647,90.6,96.7,75.8,94.6,93.8
1437,40340,"Rochester, MN (Metropolitan Statistical Area)",2016,50369,171600,1309,172909,170291,10887859,216163,93,95,90.3,92.1,96.3
1438,40380,"Rochester, NY (Metropolitan Statistical Area)",2016,47184,135400,786,136186,134614,50678704,1074063,98,98.6,93.5,100,101.4
1439,40420,"Rockford, IL (Metropolitan Statistical Area)",2016,40657,119900,1674,121574,118226,13808710,339635,88.8,96.1,72.1,91.6,91.9
1440,40580,"Rocky Mount, NC (Metropolitan Statistical Area)",2016,36933,101300,3165,104465,98135,5437896,147236,84.4,97.5,53.1,94.6,87.3
1441,40660,"Rome, GA (Metropolitan Statistical Area)",2016,36137,119600,4575,124175,115025,3494409,96698,82.1,92.1,60.8,94.3,85
1442,40900,"Sacramento-Roseville-Folsom, CA (Metropolitan Statistical Area)",2016,52634,309900,1614,311514,308286,120612129,2291533,102.3,96.4,117.3,101.6,105.9
1443,40980,"Saginaw, MI (Metropolitan Statistical Area)",2016,36635,92800,1599,94399,91201,7052562,192507,87.7,96.1,66.8,91.6,90.8
1444,41060,"St. Cloud, MN (Metropolitan Statistical Area)",2016,42750,165900,1500,167400,164400,8417932,196912,90.8,95.4,79.6,92.4,94
1445,41100,"St. George, UT (Metropolitan Statistical Area)",2016,34817,221700,5302,227002,216398,5548089,159352,94.3,98.9,88.2,93.7,97.6
1446,41140,"St. Joseph, MO-KS (Metropolitan Statistical Area)",2016,36679,114100,2299,116399,111801,4643514,126597,86.1,95.2,61.6,92.2,89.1
1447,41180,"St. Louis, MO-IL (Metropolitan Statistical Area)",2016,51443,159500,683,160183,158817,144322152,2805502,91.3,95.5,82.5,91.4,94.5
1448,41420,"Salem, OR (Metropolitan Statistical Area)",2016,39521,197200,2511,199711,194689,16472930,416818,96.2,100.4,87.4,97.1,99.6
1449,41500,"Salinas, CA (Metropolitan Statistical Area)",2016,53484,393300,4985,398285,388315,23209395,433953,108.3,96.4,151.2,101.6,112.1
1450,41540,"Salisbury, MD-DE (Metropolitan Statistical Area)",2016,45711,213000,2566,215566,210434,18223771,398676,90,92.1,83.5,94.3,93.1
1451,41620,"Salt Lake City, UT (Metropolitan Statistical Area)",2016,47392,239700,1294,240994,238406,56146787,1184721,97.8,93.8,103.9,99.8,101.3
1452,41660,"San Angelo, TX (Metropolitan Statistical Area)",2016,42135,116700,3798,120498,112902,5078794,120535,93.2,97.2,86.9,92.6,96.5
1453,41700,"San Antonio-New Braunfels, TX (Metropolitan Statistical Area)",2016,43476,144000,1023,145023,142977,105483724,2426276,93.8,97.1,90,92.6,97.1
1454,41740,"San Diego-Chula Vista-Carlsbad, CA (Metropolitan Statistical Area)",2016,56506,454600,1968,456568,452632,186813359,3306089,116.8,99.1,167.1,108.1,120.9
1455,41860,"San Francisco-Oakland-Berkeley, CA (Metropolitan Statistical Area)",2016,87228,661300,2306,663606,658994,408941255,4688198,128,112.9,190.3,115.1,132.4
1456,41940,"San Jose-Sunnyvale-Santa Clara, CA (Metropolitan Statistical Area)",2016,91517,740400,3947,744347,736453,181898674,1987593,128.5,110.4,212.7,112.1,133
1457,42020,"San Luis Obispo-Paso Robles, CA (Metropolitan Statistical Area)",2016,53006,471800,7140,478940,464660,14937322,281803,107.5,96.4,145.9,101.6,111.3
1458,42100,"Santa Cruz-Watsonville, CA (Metropolitan Statistical Area)",2016,60970,615200,10272,625472,604928,16730037,274396,125.5,110.6,177.1,112.4,129.9
1459,42140,"Santa Fe, NM (Metropolitan Statistical Area)",2016,54454,274800,4466,279266,270334,8100456,148758,98.2,93.6,106.1,100,101.7
1460,42200,"Santa Maria-Santa Barbara, CA (Metropolitan Statistical Area)",2016,57595,480000,11622,491622,468378,25591726,444340,109.9,96.4,167.1,101.6,113.8
1461,42220,"Santa Rosa-Petaluma, CA (Metropolitan Statistical Area)",2016,57378,464700,4146,468846,460554,28835169,502547,121.7,110.6,155.7,112.4,126
1462,42340,"Savannah, GA (Metropolitan Statistical Area)",2016,43351,171500,1905,173405,169595,16610102,383153,93.8,97.5,86.6,94.6,97.1
1463,42540,"Scranton--Wilkes-Barre, PA (Metropolitan Statistical Area)",2016,42880,134700,1864,136564,132836,23829375,555722,92.4,98.6,71.8,100,95.6
1464,42660,"Seattle-Tacoma-Bellevue, WA (Metropolitan Statistical Area)",2016,66330,338600,1017,339617,337583,253138461,3816355,111.2,107.6,133.7,103.7,115.1
1465,42680,"Sebastian-Vero Beach, FL (Metropolitan Statistical Area)",2016,71241,160900,3590,164490,157310,10768763,151159,92.2,92.1,90.3,94.4,95.4
1466,42700,"Sebring-Avon Park, FL (Metropolitan Statistical Area)",2016,32083,86600,2842,89442,83758,3273759,102041,83.5,92.1,68,94.3,86.5
1467,43100,"Sheboygan, WI (Metropolitan Statistical Area)",2016,48202,148200,2008,150208,146192,5544641,115030,89.2,96.1,72,91.6,92.3
1468,43300,"Sherman-Denison, TX (Metropolitan Statistical Area)",2016,39954,110000,3070,113070,106930,5125785,128291,91.4,97.4,79.5,92.6,94.6
1469,43340,"Shreveport-Bossier City, LA (Metropolitan Statistical Area)",2016,43295,131600,3077,134677,128523,17402179,401947,89.6,97.1,74.3,92.6,92.8
1470,43420,"Sierra Vista-Douglas, AZ (Metropolitan Statistical Area)",2016,37497,140700,3717,144417,136983,4712805,125686,89.2,98.9,72.1,93.7,92.4
1471,43580,"Sioux City, IA-NE-SD (Metropolitan Statistical Area)",2016,46749,113700,1996,115696,111704,6724560,143844,88.4,95.2,68.8,92.1,91.5
1472,43620,"Sioux Falls, SD (Metropolitan Statistical Area)",2016,56065,164500,1326,165826,163174,14274351,254602,91.2,95.4,80.9,92.3,94.4
1473,43780,"South Bend-Mishawaka, IN-MI (Metropolitan Statistical Area)",2016,43357,118700,1671,120371,117029,13923704,321144,87.9,95.9,69.4,91.3,91
1474,43900,"Spartanburg, SC (Metropolitan Statistical Area)",2016,40965,119400,1769,121169,117631,12324966,300867,89.3,97.5,68.5,94.6,92.4
1475,44060,"Spokane-Spokane Valley, WA (Metropolitan Statistical Area)",2016,42242,185400,2231,187631,183169,22854063,541030,95.7,97,85.1,100.9,99
1476,44100,"Springfield, IL (Metropolitan Statistical Area)",2016,44947,133300,2300,135600,131000,9457998,210424,89.7,96.1,72.6,91.6,92.9
1477,44140,"Springfield, MA (Metropolitan Statistical Area)",2016,48958,214600,1684,216284,212916,34260875,699804,98.7,98.7,92.8,102.8,102.2
1478,44180,"Springfield, MO (Metropolitan Statistical Area)",2016,38433,133700,1500,135200,132200,17599347,457917,86.9,95.3,66.4,92.3,90
1479,44220,"Springfield, OH (Metropolitan Statistical Area)",2016,38026,103200,2292,105492,100908,5122990,134723,86.8,96.1,63.7,91.6,89.8
1480,44300,"State College, PA (Metropolitan Statistical Area)",2016,42603,206000,3836,209836,202164,6903061,162034,102.6,98.6,115.4,100,106.2
1481,44420,"Staunton, VA (Metropolitan Statistical Area) *",2016,41447,184400,4258,188658,180142,5004575,120747,85.3,92.1,71.4,94.3,88.3
1482,44700,"Stockton, CA (Metropolitan Statistical Area)",2016,41624,246900,3410,250310,243490,30502705,732809,99.9,96.4,104.5,101.6,103.4
1483,44940,"Sumter, SC (Metropolitan Statistical Area)",2016,34620,108900,3984,112884,104916,4893040,141334,86.5,95,59.5,94.7,89.5
1484,45060,"Syracuse, NY (Metropolitan Statistical Area)",2016,45516,128200,1121,129321,127079,29785016,654391,96.7,98.6,87.8,100,100.1
1485,45220,"Tallahassee, FL (Metropolitan Statistical Area)",2016,39592,166000,2091,168091,163909,14992386,378672,93.3,97.1,85.5,94.6,96.6
1486,45300,"Tampa-St. Petersburg-Clearwater, FL (Metropolitan Statistical Area)",2016,43778,152600,753,153353,151847,133477350,3048963,98.2,93.9,103.2,100.7,101.6
1487,45460,"Terre Haute, IN (Metropolitan Statistical Area)",2016,35318,88600,1509,90109,87091,6613065,187241,86.6,95.7,62.4,91.3,89.7
1488,45500,"Texarkana, TX-AR (Metropolitan Statistical Area)",2016,35925,99000,3564,102564,95436,5372361,149543,87.4,96.2,62.8,92.7,90.4
1489,45540,"The Villages, FL (Metropolitan Statistical Area)",2016,42535,227000,4564,231564,222436,5189676,122009,93.5,92.2,94,94.4,96.8
1490,45780,"Toledo, OH (Metropolitan Statistical Area)",2016,43895,116700,1357,118057,115343,28331820,645441,87.4,96,66.2,91.5,90.5
1491,45820,"Topeka, KS (Metropolitan Statistical Area)",2016,42854,123600,1987,125587,121613,9990882,233139,88.3,95.1,70.2,92.1,91.4
1492,45940,"Trenton-Princeton, NJ (Metropolitan Statistical Area)",2016,64689,277400,3631,281031,273769,23786171,367699,109.2,100.9,120.1,111.3,113
1493,46060,"Tucson, AZ (Metropolitan Statistical Area)",2016,40052,160800,1039,161839,159761,40721611,1016707,94.3,93.6,87.7,100,97.6
1494,46140,"Tulsa, OK (Metropolitan Statistical Area)",2016,47973,134700,884,135584,133816,47431057,988706,90.1,97.2,74.2,92.6,93.3
1495,46220,"Tuscaloosa, AL (Metropolitan Statistical Area)",2016,35822,150600,2219,152819,148381,8958924,250099,87.2,96.2,65.7,91.9,90.2
1496,46300,"Twin Falls, ID (Metropolitan Statistical Area)",2016,37150,147200,3743,150943,143457,3984373,107252,90.3,98.9,73.6,93.7,93.5
1497,46340,"Tyler, TX (Metropolitan Statistical Area)",2016,46386,137600,3587,141187,134013,10444389,225161,93.2,97.4,86.5,92.6,96.5
1498,46520,"Urban Honolulu, HI (Metropolitan Statistical Area)",2016,54992,602700,3954,606654,598746,54567246,992268,124.4,114.4,179,106.5,128.8
1499,46540,"Utica-Rome, NY (Metropolitan Statistical Area)",2016,40517,113200,1367,114567,111833,11863887,292811,93.5,98.6,75.7,100,96.8
1500,46660,"Valdosta, GA (Metropolitan Statistical Area)",2016,33770,122100,4373,126473,117727,4878822,144471,81.6,92.1,62.5,94.3,84.4
1501,46700,"Vallejo, CA (Metropolitan Statistical Area)",2016,47207,305900,4753,310653,301147,20717177,438858,118.2,110.6,137.6,112.4,122.4
1502,47020,"Victoria, TX (Metropolitan Statistical Area)",2016,41812,124200,4553,128753,119647,4177574,99914,93.6,97.1,88.6,92.6,96.9
1503,47220,"Vineland-Bridgeton, NJ (Metropolitan Statistical Area)",2016,37617,161900,2664,164564,159236,5764105,153233,98.6,100.9,88.1,104,102
1504,47260,"Virginia Beach-Norfolk-Newport News, VA-NC (Metropolitan Statistical Area) *",2016,47135,234200,1223,235423,232977,82899477,1758763,97.9,97.2,104,94.6,101.3
1505,47300,"Visalia, CA (Metropolitan Statistical Area)",2016,38656,169600,2344,171944,167256,17752145,459235,94.8,96.4,82.4,101.6,98.1
1506,47380,"Waco, TX (Metropolitan Statistical Area)",2016,38147,114100,2612,116712,111488,10102419,264829,91,96.8,78.5,92.7,94.2
1507,47460,"Walla Walla, WA (Metropolitan Statistical Area)",2016,42298,189400,6476,195876,182924,2538208,60008,96,101.8,87.2,95.7,99.4
1508,47580,"Warner Robins, GA (Metropolitan Statistical Area)",2016,39423,133800,3024,136824,130776,7037222,178507,89,97.5,69.1,94.6,92.1
1509,47900,"Washington-Arlington-Alexandria, DC-VA-MD-WV (Metropolitan Statistical Area) *",2016,67952,387400,974,388374,386426,417860186,6149301,117.6,104.3,165.8,109,121.7
1510,47940,"Waterloo-Cedar Falls, IA (Metropolitan Statistical Area)",2016,42179,136400,2158,138558,134242,7175015,170110,90,95.1,76.8,92.1,93.2
1511,48060,"Watertown-Fort Drum, NY (Metropolitan Statistical Area)",2016,43882,144400,4274,148674,140126,4957788,112980,98.6,98.6,96.9,100,102.1
1512,48140,"Wausau-Weston, WI (Metropolitan Statistical Area)",2016,45860,145900,1732,147632,144168,7472280,162935,89.2,95.9,71.3,91.4,92.3
1513,48260,"Weirton-Steubenville, WV-OH (Metropolitan Statistical Area)",2016,36747,87300,1251,88551,86049,4382734,119269,84,95.5,52.1,92.9,87
1514,48300,"Wenatchee, WA (Metropolitan Statistical Area)",2016,45664,234300,4893,239193,229407,5352757,117221,96.7,101.8,89.4,95.7,100.1
1515,48540,"Wheeling, WV-OH (Metropolitan Statistical Area)",2016,41503,98900,2023,100923,96877,5933068,142955,85.9,97.5,56.8,94.6,88.9
1516,48620,"Wichita, KS (Metropolitan Statistical Area)",2016,46364,126300,1080,127380,125220,29564163,637653,89.1,95.4,72,92.3,92.2
1517,48660,"Wichita Falls, TX (Metropolitan Statistical Area)",2016,40377,91900,2450,94350,89450,6069794,150327,89.2,97.1,72.8,92.6,92.3
1518,48700,"Williamsport, PA (Metropolitan Statistical Area)",2016,40277,141100,2610,143710,138490,4626869,114876,93,98.6,74.8,100,96.3
1519,48900,"Wilmington, NC (Metropolitan Statistical Area)",2016,41292,203300,3943,207243,199357,11709644,283580,93.5,96.7,87.5,94.6,96.8
1520,49020,"Winchester, VA-WV (Metropolitan Statistical Area) *",2016,44911,209200,5862,215062,203338,6096199,135739,92.6,92.1,91.3,94.3,95.8
1521,49180,"Winston-Salem, NC (Metropolitan Statistical Area)",2016,41806,143700,1460,145160,142240,27634591,661024,89.2,97.5,68.4,94.6,92.4
1522,49340,"Worcester, MA-CT (Metropolitan Statistical Area)",2016,51871,245200,1596,246796,243604,48573112,936422,104.1,101.9,103.4,106.8,107.7
1523,49420,"Yakima, WA (Metropolitan Statistical Area)",2016,40160,160700,2451,163151,158249,10013091,249327,93.8,96.4,77.5,101.6,97.1
1524,49620,"York-Hanover, PA (Metropolitan Statistical Area)",2016,46180,168300,1158,169458,167142,20489705,443693,96.6,98.6,87.3,100,99.9
1525,49660,"Youngstown-Warren-Boardman, OH-PA (Metropolitan Statistical Area)",2016,39595,101000,1111,102111,99889,21562579,544582,86.8,96.4,60.7,93.4,89.8
1526,49700,"Yuba City, CA (Metropolitan Statistical Area)",2016,41173,203600,6015,209615,197585,7027920,170694,97.4,96.4,93.4,101.6,100.8
1527,49740,"Yuma, AZ (Metropolitan Statistical Area) *",2016,32527,113400,1792,115192,111608,6741154,207247,90.1,93.6,72.5,100,93.3
1528,10180,"Abilene, TX (Metropolitan Statistical Area)",2015,40503,94000,2341,96341,91659,6872897,169688,90.9,97.4,76.9,93.5,93.3
1529,10420,"Akron, OH (Metropolitan Statistical Area)",2015,45049,137900,1141,139041,136759,31731732,704382,90.5,95.6,77.8,91.7,92.8
1530,10500,"Albany, GA (Metropolitan Statistical Area)",2015,35060,106100,2775,108875,103325,5272524,150387,83.9,97.2,55.6,93.5,86.1
1531,10540,"Albany-Lebanon, OR (Metropolitan Statistical Area)",2015,38344,170300,3338,173638,166962,4610378,120236,94,100.2,85.5,93.4,96.5
1532,10580,"Albany-Schenectady-Troy, NY (Metropolitan Statistical Area)",2015,52722,197400,1408,198808,195992,46347149,879085,100.8,98.1,104.9,101.8,103.4
1533,10740,"Albuquerque, NM (Metropolitan Statistical Area) *",2015,38924,177100,1864,178964,175236,35265941,906026,96.4,95.2,91.4,101.4,98.9
1534,10780,"Alexandria, LA (Metropolitan Statistical Area)",2015,39982,120100,3086,123186,117014,6160540,154082,88.3,97.6,66.6,93.5,90.6
1535,10900,"Allentown-Bethlehem-Easton, PA-NJ (Metropolitan Statistical Area)",2015,48632,199800,1498,201298,198302,40378661,830295,101.3,98.6,102,104.2,103.9
1536,11020,"Altoona, PA (Metropolitan Statistical Area)",2015,42031,110600,2812,113412,107788,5236887,124596,90.4,98.1,62.2,101.8,92.7
1537,11100,"Amarillo, TX (Metropolitan Statistical Area)",2015,43286,122200,2044,124244,120156,11324431,261618,93.1,97.9,83.4,93.5,95.5
1538,11180,"Ames, IA (Metropolitan Statistical Area)",2015,40435,166000,3066,169066,162934,4976664,123079,91.5,93.3,91.2,89.5,93.8
1539,11260,"Anchorage, AK (Metropolitan Statistical Area)",2015,59719,272300,2614,274914,269686,23804702,398609,108.5,102.1,146.3,99,111.3
1540,11460,"Ann Arbor, MI (Metropolitan Statistical Area)",2015,52270,208200,2920,211120,205280,18972715,362975,101.5,98.8,113.6,98.5,104.1
1541,11500,"Anniston-Oxford, AL (Metropolitan Statistical Area)",2015,34423,105900,3221,109121,102679,3974840,115469,84.3,98.2,52.8,93.5,86.5
1542,11540,"Appleton, WI (Metropolitan Statistical Area)",2015,46383,158100,1516,159616,156584,10813954,233146,91.3,96.3,78.5,92.3,93.7
1543,11700,"Asheville, NC (Metropolitan Statistical Area)",2015,40550,182500,2642,185142,179858,18028032,444593,92.9,96.2,87.5,93.5,95.3
1544,12020,"Athens-Clarke County, GA (Metropolitan Statistical Area)",2015,36703,157800,3035,160835,154765,7434706,202565,91.8,97.9,80,93.5,94.2
1545,12060,"Atlanta-Sandy Springs-Alpharetta, GA (Metropolitan Statistical Area)",2015,46859,168100,727,168827,167373,266444291,5686048,96.5,98.6,92.2,96.9,99
1546,12100,"Atlantic City-Hammonton, NJ (Metropolitan Statistical Area)",2015,44423,225600,3238,228838,222362,12000996,270153,104.5,100.6,105.8,107.5,107.2
1547,12220,"Auburn-Opelika, AL (Metropolitan Statistical Area)",2015,34507,154300,3405,157705,150895,5415988,156954,84.7,91.5,70,93.2,86.9
1548,12260,"Augusta-Richmond County, GA-SC (Metropolitan Statistical Area)",2015,38389,128200,1778,129978,126422,22633236,589574,88.6,97.6,68.7,93.5,90.9
1549,12420,"Austin-Round Rock-Georgetown, TX (Metropolitan Statistical Area)",2015,51484,208700,1369,210069,207331,103077251,2002134,99.7,98.2,115,93.5,102.3
1550,12540,"Bakersfield, CA (Metropolitan Statistical Area)",2015,38051,167400,1619,169019,165781,33334249,876031,96.9,95.2,93.5,101.5,99.4
1551,12580,"Baltimore-Columbia-Towson, MD (Metropolitan Statistical Area)",2015,56247,277500,1111,278611,276389,156931804,2790053,107.6,102.9,117.6,105.5,110.4
1552,12620,"Bangor, ME (Metropolitan Statistical Area)",2015,37889,137400,2809,140209,134591,5756406,151929,97.1,98.1,88.9,101.8,99.6
1553,12700,"Barnstable Town, MA (Metropolitan Statistical Area)",2015,65467,363500,3805,367305,359695,14001940,213877,103.4,98.1,117.2,101.8,106.1
1554,12940,"Baton Rouge, LA (Metropolitan Statistical Area)",2015,43691,161800,1129,162929,160671,37188072,851167,92.9,96.9,85.3,93.5,95.3
1555,12980,"Battle Creek, MI (Metropolitan Statistical Area)",2015,37000,96000,2401,98401,93599,4970151,134327,90,96.3,75.2,92.3,92.4
1556,13020,"Bay City, MI (Metropolitan Statistical Area)",2015,38466,92800,2164,94964,90636,4048099,105237,87.6,96.3,65.5,92.3,89.9
1557,13140,"Beaumont-Port Arthur, TX (Metropolitan Statistical Area)",2015,41754,97700,1686,99386,96014,16485366,394825,90.3,97.7,71.5,93.5,92.6
1558,13220,"Beckley, WV (Metropolitan Statistical Area)",2015,35235,90100,2915,93015,87185,4301190,122070,79.1,91.5,54.1,93.2,81.1
1559,13380,"Bellingham, WA (Metropolitan Statistical Area)",2015,43939,274700,3585,278285,271115,9307821,211836,99.4,95.2,105.5,101.5,102
1560,13460,"Bend, OR (Metropolitan Statistical Area)",2015,47491,253400,7854,261254,245546,8275134,174246,97.3,100.2,98,93.4,99.8
1561,13740,"Billings, MT (Metropolitan Statistical Area)",2015,48098,193500,2800,196300,190700,8482472,176357,97.9,95.5,98,101.1,100.4
1562,13780,"Binghamton, NY (Metropolitan Statistical Area)",2015,40266,110500,1844,112344,108656,9876545,245283,96,98.1,84.2,101.8,98.5
1563,13820,"Birmingham-Hoover, AL (Metropolitan Statistical Area)",2015,46245,146200,1558,147758,144642,49933414,1079752,89.3,97.8,69,93.5,91.7
1564,13900,"Bismarck, ND (Metropolitan Statistical Area)",2015,55792,185100,4096,189196,181004,6992098,125325,93,96.1,87.3,92.2,95.4
1565,13980,"Blacksburg-Christiansburg, VA (Metropolitan Statistical Area) *",2015,34870,162500,3201,165701,159299,5778761,165725,89.2,91.4,80.8,93.4,91.5
1566,14010,"Bloomington, IL (Metropolitan Statistical Area)",2015,46027,155400,2008,157408,153392,7969221,173141,93,95.9,88,92,95.5
1567,14020,"Bloomington, IN (Metropolitan Statistical Area)",2015,36503,152300,2896,155196,149404,6025741,165073,93.6,96,91.7,92,96
1568,14100,"Bloomsburg-Berwick, PA (Metropolitan Statistical Area)",2015,40902,145700,3000,148700,142700,3475877,84980,94.7,98.1,78.8,101.8,97.1
1569,14260,"Boise City, ID (Metropolitan Statistical Area)",2015,41341,167800,1435,169235,166365,27890191,674640,94.3,95.4,81.6,101.2,96.7
1570,14460,"Boston-Cambridge-Newton, MA-NH (Metropolitan Statistical Area)",2015,69399,368900,1071,369971,367829,331613402,4778340,110.9,102.3,140.7,107.2,113.7
1571,14500,"Boulder, CO (Metropolitan Statistical Area) *",2015,64287,368800,4139,372939,364661,20444932,318027,108.7,100,144.1,98.7,111.5
1572,14540,"Bowling Green, KY (Metropolitan Statistical Area)",2015,34626,124600,2975,127575,121625,5869334,169507,85.6,91.3,65.7,93.5,87.8
1573,14740,"Bremerton-Silverdale-Port Orchard, WA (Metropolitan Statistical Area)",2015,48874,258700,3478,262178,255222,12669582,259232,106.8,107.3,110.8,104,109.5
1574,14860,"Bridgeport-Stamford-Norwalk, CT (Metropolitan Statistical Area)",2015,104590,416000,3816,419816,412184,98831179,944943,118.6,109.6,146.2,116.2,121.7
1575,15180,"Brownsville-Harlingen, TX (Metropolitan Statistical Area)",2015,26636,79300,1368,80668,77932,11172451,419450,84,98.2,56.5,93.5,86.2
1576,15260,"Brunswick, GA (Metropolitan Statistical Area)",2015,37151,132000,6540,138540,125460,4301360,115779,86.4,91.5,74.4,93.2,88.7
1577,15380,"Buffalo-Cheektowaga, NY (Metropolitan Statistical Area)",2015,45423,125000,940,125940,124060,51464192,1133002,95,98.1,78.6,101.8,97.5
1578,15500,"Burlington, NC (Metropolitan Statistical Area)",2015,36870,138100,3305,141405,134795,5789896,157037,90.1,98.2,72.4,93.5,92.4
1579,15540,"Burlington-South Burlington, VT (Metropolitan Statistical Area)",2015,52743,253900,3263,257163,250637,11453310,217152,104.4,98.1,122.9,101.8,107.1
1580,15680,"California-Lexington Park, MD (Metropolitan Statistical Area)",2015,52245,297200,5387,302587,291813,5798401,110985,98.7,91.5,115.9,93.2,101.3
1581,15940,"Canton-Massillon, OH (Metropolitan Statistical Area)",2015,41306,122100,1327,123427,120773,16623077,402433,88,96.3,65.6,92.3,90.3
1582,15980,"Cape Coral-Fort Myers, FL (Metropolitan Statistical Area)",2015,46420,157400,1981,159381,155419,32477798,699644,95.4,98.2,93.7,93.5,97.9
1583,16020,"Cape Girardeau, MO-IL (Metropolitan Statistical Area)",2015,39495,128700,3807,132507,124893,3843513,97316,83.1,93.3,64.2,89.5,85.2
1584,16060,"Carbondale-Marion, IL (Metropolitan Statistical Area)",2015,37592,100500,3756,104256,96744,5241030,139419,84.2,93.3,66.9,89.5,86.4
1585,16180,"Carson City, NV (Metropolitan Statistical Area)",2015,45514,186000,8329,194329,177671,2460841,54068,95.8,100.2,92.1,93.4,98.3
1586,16220,"Casper, WY (Metropolitan Statistical Area)",2015,72877,185600,3988,189588,181612,5985905,82137,97.1,95.2,94.2,101.5,99.7
1587,16300,"Cedar Rapids, IA (Metropolitan Statistical Area)",2015,48342,146000,1512,147512,144488,12873980,266312,88.9,95.9,70.4,91.9,91.2
1588,16540,"Chambersburg-Waynesboro, PA (Metropolitan Statistical Area)",2015,41914,173400,2584,175984,170816,6414793,153048,94.9,98.1,78.3,101.8,97.4
1589,16580,"Champaign-Urbana, IL (Metropolitan Statistical Area)",2015,44362,143900,2309,146209,141591,10014008,225732,92.9,96,88.6,92,95.3
1590,16620,"Charleston, WV (Metropolitan Statistical Area)",2015,40307,98600,2027,100627,96573,10917407,270858,87.4,97.7,61.4,93.5,89.7
1591,16700,"Charleston-North Charleston, SC (Metropolitan Statistical Area)",2015,45117,189600,2091,191691,187509,33620319,745185,96.2,98.2,96.9,93.5,98.7
1592,16740,"Charlotte-Concord-Gastonia, NC-SC (Metropolitan Statistical Area)",2015,46624,166000,876,166876,165124,114129669,2447898,93.5,97.7,85.8,93.5,96
1593,16820,"Charlottesville, VA (Metropolitan Statistical Area) *",2015,56828,261300,4190,265490,257110,12018719,211494,98.1,97.2,109.5,93.6,100.7
1594,16860,"Chattanooga, TN-GA (Metropolitan Statistical Area)",2015,42011,144700,1994,146694,142706,22988880,547205,90,97.8,71.9,93.5,92.3
1595,16940,"Cheyenne, WY (Metropolitan Statistical Area)",2015,49604,190000,4034,194034,185966,4810053,96969,97.1,95.2,94.3,101.5,99.7
1596,16980,"Chicago-Naperville-Elgin, IL-IN-WI (Metropolitan Statistical Area)",2015,55508,214400,651,215051,213749,530240862,9552554,103.7,99.7,115.4,102.3,106.4
1597,17020,"Chico, CA (Metropolitan Statistical Area)",2015,40769,221700,4189,225889,217511,9157915,224631,98.8,95.2,102,101.5,101.3
1598,17140,"Cincinnati, OH-KY-IN (Metropolitan Statistical Area)",2015,48524,153400,729,154129,152671,105851074,2181427,90.1,95.2,78.9,91.2,92.5
1599,17300,"Clarksville, TN-KY (Metropolitan Statistical Area)",2015,38859,137500,2180,139680,135320,11380950,292878,91,97.9,77.7,93.5,93.3
1600,17420,"Cleveland, TN (Metropolitan Statistical Area)",2015,36329,141400,4450,145850,136950,4379147,120543,84.3,91.5,67.5,93.2,86.5
1601,17460,"Cleveland-Elyria, OH (Metropolitan Statistical Area)",2015,48569,138900,643,139543,138257,100247178,2064012,90.6,95.6,78.6,91.7,92.9
1602,17660,"Coeur d'Alene, ID (Metropolitan Statistical Area)",2015,40469,185700,4124,189824,181576,6044776,149367,94,100.2,85.3,93.4,96.4
1603,17780,"College Station-Bryan, TX (Metropolitan Statistical Area)",2015,36218,150000,3564,153564,146436,9074949,250567,93.6,97.5,87.7,93.5,96
1604,17820,"Colorado Springs, CO (Metropolitan Statistical Area)",2015,44860,219300,1804,221104,217496,31284563,697389,99.3,95.4,104.7,101.2,101.8
1605,17860,"Columbia, MO (Metropolitan Statistical Area)",2015,42660,169400,3161,172561,166239,8623812,202152,91.1,96.3,79.5,92.3,93.4
1606,17900,"Columbia, SC (Metropolitan Statistical Area)",2015,41297,140600,1275,141875,139325,33415217,809136,91.8,97.6,79.7,93.5,94.2
1607,17980,"Columbus, GA-AL (Metropolitan Statistical Area)",2015,37339,135700,3065,138765,132635,12051963,322772,89.4,98.1,71.9,93.5,91.7
1608,18020,"Columbus, IN (Metropolitan Statistical Area)",2015,45925,136000,3423,139423,132577,3740935,81458,87.9,93.3,77.7,89.5,90.2
1609,18140,"Columbus, OH (Metropolitan Statistical Area)",2015,47279,159100,876,159976,158224,95862365,2027568,92.1,96.1,83.5,92.1,94.5
1610,18580,"Corpus Christi, TX (Metropolitan Statistical Area)",2015,42424,111500,1649,113149,109851,18141476,427621,93.4,97.9,85.5,93.5,95.8
1611,18700,"Corvallis, OR (Metropolitan Statistical Area)",2015,41883,269700,6344,276044,263356,3699685,88333,99.7,100.2,108,93.4,102.3
1612,18880,"Crestview-Fort Walton Beach-Destin, FL (Metropolitan Statistical Area)",2015,46819,182800,4496,187296,178304,12211066,260814,94.9,95,97.1,93.8,97.4
1613,19060,"Cumberland, MD-WV (Metropolitan Statistical Area)",2015,36686,120200,3379,123579,116821,3664143,99879,87.4,98.2,63.5,93.5,89.7
1614,19100,"Dallas-Fort Worth-Arlington, TX (Metropolitan Statistical Area)",2015,50670,156500,536,157036,155964,356850208,7042566,99.5,99.1,101.4,99,102.1
1615,19140,"Dalton, GA (Metropolitan Statistical Area)",2015,33360,111700,3585,115285,108115,4773827,143099,84.4,91.5,66.9,93.2,86.6
1616,19180,"Danville, IL (Metropolitan Statistical Area)",2015,36413,75800,1802,77602,73998,2882836,79170,81,93.3,58.1,89.5,83.1
1617,19300,"Daphne-Fairhope-Foley, AL (Metropolitan Statistical Area)",2015,41613,169300,2933,172233,166367,8444952,202939,91,98.2,80.1,93.5,93.3
1618,19340,"Davenport-Moline-Rock Island, IA-IL (Metropolitan Statistical Area)",2015,45188,125700,1758,127458,123942,17324328,383381,89.4,96.2,72.1,92.2,91.7
1619,19460,"Decatur, AL (Metropolitan Statistical Area)",2015,35688,116300,3102,119402,113198,5438588,152392,86.3,98.2,56.9,93.5,88.5
1620,19500,"Decatur, IL (Metropolitan Statistical Area)",2015,44658,94900,2070,96970,92830,4793683,107343,86.5,96.3,60.9,92.3,88.7
1621,19660,"Deltona-Daytona Beach-Ormond Beach, FL (Metropolitan Statistical Area)",2015,38464,138900,1907,140807,136993,23892533,621166,95.6,98.2,94.6,93.5,98.1
1622,19740,"Denver-Aurora-Lakewood, CO (Metropolitan Statistical Area) *",2015,56707,267000,1072,268072,265928,159512262,2812896,104.6,100,122.2,98.6,107.3
1623,19780,"Des Moines-West Des Moines, IA (Metropolitan Statistical Area)",2015,49894,160100,1291,161391,158809,32905966,659522,93.8,96.2,91.4,92.2,96.3
1624,19820,"Detroit-Warren-Dearborn, MI (Metropolitan Statistical Area)",2015,47776,127500,744,128244,126756,205899644,4309673,96.2,98.8,87,98.5,98.7
1625,20020,"Dothan, AL (Metropolitan Statistical Area)",2015,37808,108700,2366,111066,106334,5595294,147992,84.6,96.8,57.4,93.5,86.8
1626,20100,"Dover, DE (Metropolitan Statistical Area)",2015,37982,200500,3818,204318,196682,6575805,173128,94.3,98.2,89.2,93.5,96.8
1627,20220,"Dubuque, IA (Metropolitan Statistical Area)",2015,44922,149400,2259,151659,147141,4350691,96850,91.2,96.3,79.7,92.3,93.6
1628,20260,"Duluth, MN-WI (Metropolitan Statistical Area)",2015,42326,141000,1747,142747,139253,12263469,289741,89.8,96,76.3,92,92.1
1629,20500,"Durham-Chapel Hill, NC (Metropolitan Statistical Area)",2015,47670,197600,2836,200436,194764,28969590,607706,95.4,97.9,93.7,93.5,97.9
1630,20700,"East Stroudsburg, PA (Metropolitan Statistical Area)",2015,38313,174500,3522,178022,170978,6378432,166481,100,98.1,100.9,101.8,102.6
1631,20740,"Eau Claire, WI (Metropolitan Statistical Area)",2015,43297,150600,2327,152927,148273,7165751,165501,90.5,96.3,76.7,92.3,92.9
1632,20940,"El Centro, CA (Metropolitan Statistical Area)",2015,37479,151600,3755,155355,147845,6706452,178937,90.2,100.2,72.9,93.4,92.5
1633,21060,"Elizabethtown-Fort Knox, KY (Metropolitan Statistical Area)",2015,38766,137600,3309,140909,134291,5741534,148107,86,91.5,73.7,93.2,88.3
1634,21140,"Elkhart-Goshen, IN (Metropolitan Statistical Area)",2015,40290,124000,2227,126227,121773,8178645,202995,90.1,96.3,74.5,92.3,92.4
1635,21300,"Elmira, NY (Metropolitan Statistical Area)",2015,40253,100400,2657,103057,97743,3490161,86705,95.7,98.1,82.2,101.8,98.1
1636,21340,"El Paso, TX (Metropolitan Statistical Area)",2015,32824,113600,913,114513,112687,27422758,835439,89.3,98.1,73.1,93.5,91.6
1637,21420,"Enid, OK (Metropolitan Statistical Area)",2015,44042,96900,3147,100047,93753,2785546,63248,89.8,98.2,70.3,93.5,92.1
1638,21500,"Erie, PA (Metropolitan Statistical Area)",2015,40720,118200,1525,119725,116675,11327145,278174,93.4,98.1,73.9,101.8,95.8
1639,21660,"Eugene-Springfield, OR (Metropolitan Statistical Area)",2015,41190,215300,2425,217725,212875,14908517,361946,97.6,95.2,96.5,101.5,100.1
1640,21780,"Evansville, IN-KY (Metropolitan Statistical Area)",2015,43391,123400,2111,125511,121289,13667426,314983,88.9,96.3,69.4,92.3,91.2
1641,21820,"Fairbanks, AK (Metropolitan Statistical Area) *",2015,53753,218100,6608,224708,211492,5355702,99636,107.1,100.2,151.5,93.4,109.9
1642,22020,"Fargo, ND-MN (Metropolitan Statistical Area)",2015,50423,167700,2110,169810,165590,11743034,232891,91.7,96.3,81.9,92.3,94.1
1643,22140,"Farmington, NM (Metropolitan Statistical Area)",2015,34458,145400,5633,151033,139767,4419133,128246,90.5,100.2,71.1,93.4,92.8
1644,22180,"Fayetteville, NC (Metropolitan Statistical Area)",2015,34554,131000,2150,133150,128850,17691050,511976,90.7,97.6,78,93.5,93
1645,22220,"Fayetteville-Springdale-Rogers, AR (Metropolitan Statistical Area)",2015,58337,146800,1967,148767,144833,28685825,491730,89.9,97.9,70.6,93.4,92.3
1646,22380,"Flagstaff, AZ (Metropolitan Statistical Area)",2015,42782,219300,6216,225516,213084,5945052,138962,99.2,100.2,106.1,93.4,101.7
1647,22420,"Flint, MI (Metropolitan Statistical Area)",2015,37118,88500,1104,89604,87396,15235343,410461,91.3,98.8,67.6,98.5,93.7
1648,22500,"Florence, SC (Metropolitan Statistical Area)",2015,36523,109000,2872,111872,106128,7532375,206235,85.6,96.6,59.7,93.5,87.8
1649,22520,"Florence-Muscle Shoals, AL (Metropolitan Statistical Area)",2015,35405,112300,2946,115246,109354,5200165,146876,83.7,98.2,50.2,93.5,85.8
1650,22540,"Fond du Lac, WI (Metropolitan Statistical Area)",2015,43860,146100,2354,148454,143746,4471789,101955,87.6,93.3,76.1,89.5,89.9
1651,22660,"Fort Collins, CO (Metropolitan Statistical Area)",2015,47007,263400,2806,266206,260594,15667640,333303,101.3,95.2,115.9,101.5,103.9
1652,22900,"Fort Smith, AR-OK (Metropolitan Statistical Area)",2015,35448,103000,2126,105126,100874,8820118,248820,85.4,97.4,57.9,93.5,87.6
1653,23060,"Fort Wayne, IN (Metropolitan Statistical Area)",2015,42343,116000,1234,117234,114766,16971507,400806,88.9,96.3,69.5,92.3,91.2
1654,23420,"Fresno, CA (Metropolitan Statistical Area)",2015,40175,194600,2414,197014,192186,38949236,969488,96.3,95.2,90.8,101.5,98.8
1655,23460,"Gadsden, AL (Metropolitan Statistical Area)",2015,34344,100400,3087,103487,97313,3537329,102998,84.7,98.2,53.7,93.5,86.9
1656,23540,"Gainesville, FL (Metropolitan Statistical Area)",2015,38583,159400,3016,162416,156384,12193554,316031,94.7,97.9,91.1,93.5,97.1
1657,23580,"Gainesville, GA (Metropolitan Statistical Area)",2015,39010,159700,2720,162420,156980,7499427,192245,89.2,91.5,81.8,93.2,91.5
1658,23900,"Gettysburg, PA (Metropolitan Statistical Area)",2015,44685,193100,2978,196078,190122,4549269,101808,96.8,98.1,87,101.8,99.4
1659,24020,"Glens Falls, NY (Metropolitan Statistical Area)",2015,41451,163900,2134,166034,161766,5250480,126666,97.4,98.1,89.2,101.8,99.9
1660,24140,"Goldsboro, NC (Metropolitan Statistical Area)",2015,35495,110400,4309,114709,106091,4413573,124342,87.8,98.2,64.4,93.5,90
1661,24220,"Grand Forks, ND-MN (Metropolitan Statistical Area)",2015,46448,153600,2678,156278,150922,4730642,101849,92.9,96.3,87.2,92.3,95.3
1662,24260,"Grand Island, NE (Metropolitan Statistical Area)",2015,42060,116300,3118,119418,113182,3167923,75319,86.2,93.4,67.4,89.7,88.4
1663,24300,"Grand Junction, CO (Metropolitan Statistical Area)",2015,40795,199000,4494,203494,194506,6038686,148025,94.8,100.2,88.8,93.4,97.3
1664,24340,"Grand Rapids-Kentwood, MI (Metropolitan Statistical Area)",2015,45819,141100,883,141983,140217,47874136,1044842,92.7,95.9,86.6,92,95.1
1665,24420,"Grants Pass, OR (Metropolitan Statistical Area)",2015,36695,215900,7319,223219,208581,3101754,84528,94.4,100.2,87.1,93.4,96.9
1666,24500,"Great Falls, MT (Metropolitan Statistical Area)",2015,43393,162100,2136,164236,159964,3552956,81878,93.1,95.2,76.6,101.5,95.5
1667,24540,"Greeley, CO (Metropolitan Statistical Area) *",2015,43925,210100,3024,213124,207076,12554457,285819,98.1,100,94.6,98.7,100.7
1668,24580,"Green Bay, WI (Metropolitan Statistical Area)",2015,47050,156800,1321,158121,155479,14851555,315652,90.6,95.9,78,91.9,93
1669,24660,"Greensboro-High Point, NC (Metropolitan Statistical Area)",2015,40447,140700,1241,141941,139459,30387253,751285,90.2,97.7,72.7,93.5,92.5
1670,24780,"Greenville, NC (Metropolitan Statistical Area)",2015,37802,135300,3761,139061,131539,6655771,176071,88.2,98.2,67.3,93.5,90.5
1671,24860,"Greenville-Anderson, SC (Metropolitan Statistical Area)",2015,40251,140000,1239,141239,138761,35119779,872521,89.9,97.9,71.8,93.5,92.2
1672,25060,"Gulfport-Biloxi, MS (Metropolitan Statistical Area)",2015,34962,130600,2470,133070,128130,14215633,406604,89.5,98.2,72.9,93.5,91.9
1673,25180,"Hagerstown-Martinsburg, MD-WV (Metropolitan Statistical Area)",2015,40120,180100,2874,182974,177226,11162714,278236,100.5,105.7,82.7,109.4,103.1
1674,25220,"Hammond, LA (Metropolitan Statistical Area)",2015,35384,137500,5263,142763,132237,4554443,128716,85.9,91.5,72.2,93.2,88.1
1675,25260,"Hanford-Corcoran, CA (Metropolitan Statistical Area)",2015,34231,169500,3251,172751,166249,5137539,150085,93.1,100.2,82.3,93.4,95.5
1676,25420,"Harrisburg-Carlisle, PA (Metropolitan Statistical Area)",2015,47885,170700,1147,171847,169553,27039562,564678,97.1,98.1,87.8,101.8,99.6
1677,25500,"Harrisonburg, VA (Metropolitan Statistical Area) *",2015,37181,197900,3063,200963,194837,4875189,131120,89.8,91.5,84.3,93.2,92.1
1678,25540,"Hartford-East Hartford-Middletown, CT (Metropolitan Statistical Area)",2015,59021,245000,1247,246247,243753,71518281,1211748,101.8,98.3,108.9,102.1,104.4
1679,25620,"Hattiesburg, MS (Metropolitan Statistical Area)",2015,36013,131800,5082,136882,126718,6045628,167873,82.7,91.5,64.5,93.2,84.8
1680,25860,"Hickory-Lenoir-Morganton, NC (Metropolitan Statistical Area)",2015,35687,121000,1756,122756,119244,12966594,363346,87.8,98.2,62.8,93.5,90.1
1681,25940,"Hilton Head Island-Bluffton, SC (Metropolitan Statistical Area)",2015,47734,253000,6655,259655,246345,9893220,207256,93.9,91.5,97.5,93.2,96.3
1682,25980,"Hinesville, GA (Metropolitan Statistical Area)",2015,31726,120100,5487,125587,114613,2514900,79269,90.3,91.5,86.9,93.2,92.7
1683,26140,"Homosassa Springs, FL (Metropolitan Statistical Area)",2015,35570,112300,3540,115840,108760,4990057,140287,87.8,91.5,79.7,93.2,90.1
1684,26300,"Hot Springs, AR (Metropolitan Statistical Area)",2015,36714,130700,5465,136165,125235,3591125,97814,84.8,91.5,70.1,93.2,87
1685,26380,"Houma-Thibodaux, LA (Metropolitan Statistical Area)",2015,43680,135400,3306,138706,132094,9265830,212131,91.5,98.2,76.8,93.5,93.8
1686,26420,"Houston-The Woodlands-Sugar Land, TX (Metropolitan Statistical Area)",2015,54111,149300,729,150029,148571,361016707,6671808,101.1,95.6,101.4,108,103.7
1687,26580,"Huntington-Ashland, WV-KY-OH (Metropolitan Statistical Area)",2015,36563,105900,1943,107843,103957,13426676,367224,86.3,98,57.9,93.5,88.5
1688,26620,"Huntsville, AL (Metropolitan Statistical Area)",2015,45145,162800,1939,164739,160861,20068673,444542,90.1,98.2,69.5,93.5,92.4
1689,26820,"Idaho Falls, ID (Metropolitan Statistical Area)",2015,40181,154800,2141,156941,152659,5606910,139542,89.6,100.2,69.7,93.4,92
1690,26900,"Indianapolis-Carmel-Anderson, IN (Metropolitan Statistical Area)",2015,49293,141800,887,142687,140913,97900890,1986119,92,96.2,83.1,92.2,94.4
1691,26980,"Iowa City, IA (Metropolitan Statistical Area)",2015,48343,182700,3812,186512,178888,8077596,167088,95.2,96,98.8,92,97.6
1692,27060,"Ithaca, NY (Metropolitan Statistical Area)",2015,41159,176500,4925,181425,171575,4239590,103006,106.5,98.1,133.3,101.8,109.3
1693,27100,"Jackson, MI (Metropolitan Statistical Area)",2015,35678,111500,2380,113880,109120,5682199,159264,89,96.3,70.7,92.3,91.4
1694,27140,"Jackson, MS (Metropolitan Statistical Area)",2015,41443,133300,2164,135464,131136,24780035,597928,90.2,97.7,73.3,93.5,92.6
1695,27180,"Jackson, TN (Metropolitan Statistical Area)",2015,37002,112900,2764,115664,110136,6608773,178607,82,91.4,58.7,93.4,84.1
1696,27260,"Jacksonville, FL (Metropolitan Statistical Area)",2015,44982,158100,1257,159357,156843,64982281,1444638,95.9,98.1,95.8,93.5,98.4
1697,27340,"Jacksonville, NC (Metropolitan Statistical Area)",2015,42870,154000,2858,156858,151142,8278831,193114,93.3,98.2,86.5,93.5,95.7
1698,27500,"Janesville-Beloit, WI (Metropolitan Statistical Area)",2015,40263,131800,2125,133925,129675,6482512,161006,90.8,96.3,77.8,92.3,93.2
1699,27620,"Jefferson City, MO (Metropolitan Statistical Area)",2015,39839,138400,2904,141304,135496,6012806,150928,82.7,93.3,59.8,89.5,84.8
1700,27740,"Johnson City, TN (Metropolitan Statistical Area)",2015,36927,130200,2574,132774,127626,7397672,200331,88,98.2,64.9,93.5,90.2
1701,27780,"Johnstown, PA (Metropolitan Statistical Area)",2015,39228,87100,1510,88610,85590,5336100,136028,86.6,98.1,51.2,101.8,88.9
1702,27860,"Jonesboro, AR (Metropolitan Statistical Area)",2015,34262,114000,4085,118085,109915,4401245,128459,81.8,91.5,61.5,93.2,84
1703,27900,"Joplin, MO (Metropolitan Statistical Area)",2015,36711,108000,2504,110504,105496,6486265,176686,87.1,96.3,63.2,92.3,89.4
1704,27980,"Kahului-Wailuku-Lahaina, HI (Metropolitan Statistical Area)",2015,43708,509700,15694,525394,494006,7167703,163992,107.2,100.2,144.3,93.4,110
1705,28020,"Kalamazoo-Portage, MI (Metropolitan Statistical Area)",2015,44161,133000,2081,135081,130919,11467476,259676,90.8,96.3,78.2,92.3,93.2
1706,28100,"Kankakee, IL (Metropolitan Statistical Area)",2015,37579,138700,3419,142119,135281,4199468,111750,96.8,99.7,82.9,102.3,99.3
1707,28140,"Kansas City, MO-KS (Metropolitan Statistical Area)",2015,49631,159500,750,160250,158750,103525367,2085913,93.6,96.8,83.1,95.5,96
1708,28420,"Kennewick-Richland, WA (Metropolitan Statistical Area)",2015,41723,178400,2384,180784,176016,11638440,278945,96.9,95.2,92.9,101.5,99.4
1709,28660,"Killeen-Temple, TX (Metropolitan Statistical Area)",2015,39653,123600,1803,125403,121797,17153266,432583,92.2,97.9,81.5,93.5,94.6
1710,28700,"Kingsport-Bristol, TN-VA (Metropolitan Statistical Area) *",2015,36787,119200,1852,121052,117348,11267172,306279,85.4,98.2,56.3,93.5,87.6
1711,28740,"Kingston, NY (Metropolitan Statistical Area)",2015,44679,222800,3177,225977,219623,8027008,179658,104.8,98.1,125.3,101.8,107.5
1712,28940,"Knoxville, TN (Metropolitan Statistical Area)",2015,41759,150800,1615,152415,149185,34986462,837818,89.5,97.4,70.2,93.5,91.8
1713,29020,"Kokomo, IN (Metropolitan Statistical Area)",2015,38144,95700,2635,98335,93065,3140701,82338,85.6,96.3,59.2,92.3,87.9
1714,29100,"La Crosse-Onalaska, WI-MN (Metropolitan Statistical Area)",2015,45532,157100,2130,159230,154970,6209947,136385,91.8,96.3,82.2,92.3,94.2
1715,29180,"Lafayette, LA (Metropolitan Statistical Area)",2015,43281,132300,3347,135647,128953,21186503,489507,89,97,69.6,93.5,91.3
1716,29200,"Lafayette-West Lafayette, IN (Metropolitan Statistical Area)",2015,35539,128100,3302,131402,124798,7945511,223573,92.6,96,87.1,92,95
1717,29340,"Lake Charles, LA (Metropolitan Statistical Area)",2015,43649,123700,3429,127129,120271,8960073,205275,88.8,98,67.8,93.5,91.1
1718,29420,"Lake Havasu City-Kingman, AZ (Metropolitan Statistical Area)",2015,29406,123200,3262,126462,119938,6015690,204574,92.2,95.2,74.9,101.5,94.6
1719,29460,"Lakeland-Winter Haven, FL (Metropolitan Statistical Area)",2015,33520,107300,1608,108908,105692,21738318,648523,93,98.2,84.4,93.5,95.4
1720,29540,"Lancaster, PA (Metropolitan Statistical Area)",2015,46660,189200,1635,190835,187565,25000790,535811,99.9,98.1,100.2,101.8,102.4
1721,29620,"Lansing-East Lansing, MI (Metropolitan Statistical Area)",2015,37695,130100,1623,131723,128477,20403161,541271,92.2,96.3,84.1,92.3,94.6
1722,29700,"Laredo, TX (Metropolitan Statistical Area)",2015,29470,109500,2253,111753,107247,7952911,269865,88.9,98.2,70.6,93.5,91.2
1723,29740,"Las Cruces, NM (Metropolitan Statistical Area)",2015,33555,138100,3899,141999,134201,7181934,214034,91.5,95.2,72.1,101.5,93.9
1724,29820,"Las Vegas-Henderson-Paradise, NV (Metropolitan Statistical Area)",2015,43028,170400,1006,171406,169394,90217603,2096717,97.8,95.2,97.6,101.5,100.3
1725,29940,"Lawrence, KS (Metropolitan Statistical Area)",2015,39508,179800,4139,183939,175661,4667486,118141,92.1,96.3,84.2,92.3,94.5
1726,30020,"Lawton, OK (Metropolitan Statistical Area)",2015,39112,113400,2677,116077,110723,5085021,130011,90.5,97.5,74.6,93.6,92.9
1727,30140,"Lebanon, PA (Metropolitan Statistical Area)",2015,42806,163800,1994,165794,161806,5884909,137479,96.1,98.1,83.5,101.8,98.6
1728,30300,"Lewiston, ID-WA (Metropolitan Statistical Area)",2015,40821,169000,3710,172710,165290,2535311,62108,90.8,100.2,72.9,93.4,93.2
1729,30340,"Lewiston-Auburn, ME (Metropolitan Statistical Area)",2015,38057,151100,2696,153796,148404,4076838,107124,95.4,98.1,81.8,101.8,97.8
1730,30460,"Lexington-Fayette, KY (Metropolitan Statistical Area)",2015,44613,164800,1475,166275,163325,22372244,501469,92,98.2,77.8,93.5,94.3
1731,30620,"Lima, OH (Metropolitan Statistical Area)",2015,38512,105400,3316,108716,102084,4008896,104095,87.8,96.3,65,92.3,90
1732,30700,"Lincoln, NE (Metropolitan Statistical Area)",2015,45245,152600,1783,154383,150817,14618323,323090,91.8,96.2,82,92.2,94.1
1733,30780,"Little Rock-North Little Rock-Conway, AR (Metropolitan Statistical Area)",2015,42433,139000,1571,140571,137429,31013896,730889,91,98,74.8,93.5,93.3
1734,30860,"Logan, UT-ID (Metropolitan Statistical Area)",2015,34486,188400,3195,191595,185205,4574600,132652,90.6,100.2,72.8,93.4,92.9
1735,30980,"Longview, TX (Metropolitan Statistical Area)",2015,40651,111900,2460,114360,109440,11535286,283767,91.5,97,79.5,93.5,93.9
1736,31020,"Longview, WA (Metropolitan Statistical Area)",2015,41037,175300,3711,179011,171589,4226719,102999,94.5,100.2,87,93.4,97
1737,31080,"Los Angeles-Long Beach-Anaheim, CA (Metropolitan Statistical Area)",2015,56945,470300,1202,471502,469098,753652141,13234696,116.9,104.7,164.8,106,119.9
1738,31140,"Louisville/Jefferson County, KY-IN (Metropolitan Statistical Area)",2015,45542,148900,959,149859,147941,56756043,1246231,91.4,97.8,76.1,93.4,93.7
1739,31180,"Lubbock, TX (Metropolitan Statistical Area)",2015,39234,110100,2149,112249,107951,12162612,310001,93.5,97.8,85.7,93.5,95.9
1740,31340,"Lynchburg, VA (Metropolitan Statistical Area) *",2015,37522,162900,2069,164969,160831,9734920,259447,91,97.9,75.5,93.5,93.3
1741,31420,"Macon-Bibb County, GA (Metropolitan Statistical Area)",2015,37694,118900,3012,121912,115888,8661795,229795,86.9,97.2,62.7,93.5,89.2
1742,31460,"Madera, CA (Metropolitan Statistical Area)",2015,35637,189700,6730,196430,182970,5472950,153576,95.3,95.2,87,101.5,97.8
1743,31540,"Madison, WI (Metropolitan Statistical Area)",2015,53433,219200,1242,220442,217958,34207708,640198,96.7,95.9,108,91.9,99.2
1744,31700,"Manchester-Nashua, NH (Metropolitan Statistical Area)",2015,54788,245700,1821,247521,243879,22407570,408985,108.5,102,126.6,106.8,111.4
1745,31740,"Manhattan, KS (Metropolitan Statistical Area)",2015,42228,173800,4695,178495,169105,5784828,136989,93.2,93.3,97.8,89.5,95.6
1746,31860,"Mankato, MN (Metropolitan Statistical Area)",2015,43442,165500,1764,167264,163736,4309424,99199,89.4,93.3,84,89.5,91.7
1747,31900,"Mansfield, OH (Metropolitan Statistical Area)",2015,36314,102500,2728,105228,99772,4419003,121688,85.1,96.3,57.2,92.3,87.3
1748,32580,"McAllen-Edinburg-Mission, TX (Metropolitan Statistical Area)",2015,25013,79200,1447,80647,77753,21002404,839667,84.9,98.2,58.4,93.5,87.1
1749,32780,"Medford, OR (Metropolitan Statistical Area)",2015,41547,218100,5263,223363,212837,8783198,211403,97.6,95.2,96.7,101.5,100.1
1750,32820,"Memphis, TN-MS-AR (Metropolitan Statistical Area)",2015,42596,133300,1274,134574,132026,56857126,1334790,91.5,97.9,77.5,93.5,93.9
1751,32900,"Merced, CA (Metropolitan Statistical Area)",2015,36794,161200,2605,163805,158595,9800267,266353,94.2,95.2,81.9,101.5,96.6
1752,33100,"Miami-Fort Lauderdale-Pompano Beach, FL (Metropolitan Statistical Area)",2015,51269,197900,1143,199043,196757,306032168,5969135,108,101.6,129.1,101.8,110.8
1753,33140,"Michigan City-La Porte, IN (Metropolitan Statistical Area)",2015,37928,123300,3029,126329,120271,4203739,110835,86,93.3,71.3,89.5,88.2
1754,33220,"Midland, MI (Metropolitan Statistical Area)",2015,40065,131200,3322,134522,127878,3351881,83662,90.2,96.3,74.5,92.3,92.5
1755,33260,"Midland, TX (Metropolitan Statistical Area)",2015,88473,164800,3778,168578,161022,14861127,167974,100.7,97.7,128.9,93.5,103.3
1756,33340,"Milwaukee-Waukesha, WI (Metropolitan Statistical Area)",2015,51611,193600,1046,194646,192554,81363823,1576496,95.9,96,95.6,95.8,98.4
1757,33460,"Minneapolis-St. Paul-Bloomington, MN-WI (Metropolitan Statistical Area)",2015,56992,213900,726,214626,213174,199682915,3503728,102,104.3,109.8,95.6,104.7
1758,33540,"Missoula, MT (Metropolitan Statistical Area)",2015,44993,239700,4217,243917,235483,5134728,114122,96.5,100.2,94.6,93.4,99
1759,33660,"Mobile, AL (Metropolitan Statistical Area)",2015,36095,122400,1892,124292,120508,15567638,431294,88,98.2,66.1,93.5,90.3
1760,33700,"Modesto, CA (Metropolitan Statistical Area)",2015,40606,190800,2746,193546,188054,21651651,533211,97.7,95.2,97.3,101.5,100.3
1761,33740,"Monroe, LA (Metropolitan Statistical Area)",2015,36850,117900,3484,121384,114416,7578788,205668,85.6,97.6,58.4,93.5,87.9
1762,33780,"Monroe, MI (Metropolitan Statistical Area)",2015,42186,137200,3190,140390,134010,6300554,149353,94.4,98.8,79.4,98.5,96.8
1763,33860,"Montgomery, AL (Metropolitan Statistical Area)",2015,39841,129300,2064,131364,127236,14875366,373365,89.4,98.1,70,93.5,91.7
1764,34060,"Morgantown, WV (Metropolitan Statistical Area)",2015,39372,150300,4253,154553,146047,5453862,138523,91.1,91.5,88.2,93.2,93.5
1765,34100,"Morristown, TN (Metropolitan Statistical Area)",2015,33333,125800,3749,129549,122051,4640403,139212,81.4,91.5,61.2,93.2,83.5
1766,34580,"Mount Vernon-Anacortes, WA (Metropolitan Statistical Area)",2015,46138,249800,5821,255621,243979,5608530,121559,98.1,100.2,101.3,93.4,100.6
1767,34620,"Muncie, IN (Metropolitan Statistical Area)",2015,33929,87700,1685,89385,86015,3927884,115767,87.9,96.3,68.4,92.3,90.1
1768,34740,"Muskegon, MI (Metropolitan Statistical Area)",2015,35111,99000,1707,100707,97293,6054786,172447,86.8,96.3,64.1,92.3,89.1
1769,34820,"Myrtle Beach-Conway-North Myrtle Beach, SC-NC (Metropolitan Statistical Area)",2015,35508,165100,1782,166882,163318,15311057,431198,90.8,96.5,82.7,93.5,93.2
1770,34900,"Napa, CA (Metropolitan Statistical Area)",2015,64697,466800,8023,474823,458777,9113309,140862,123.6,112.1,165.5,113.3,126.8
1771,34940,"Naples-Marco Island, FL (Metropolitan Statistical Area)",2015,83159,272800,5482,278282,267318,29607837,356041,100.4,98.2,120,93.5,103
1772,34980,"Nashville-Davidson--Murfreesboro--Franklin, TN (Metropolitan Statistical Area)",2015,51865,174700,906,175606,173794,93598973,1804671,94,97.8,87.8,93.5,96.4
1773,35100,"New Bern, NC (Metropolitan Statistical Area)",2015,40395,149400,3718,153118,145682,5064377,125371,86.8,91.5,76,93.2,89
1774,35300,"New Haven-Milford, CT (Metropolitan Statistical Area)",2015,51867,245200,1861,247061,243339,44615600,860186,111.2,106.8,115,113.4,114.1
1775,35380,"New Orleans-Metairie, LA (Metropolitan Statistical Area)",2015,48260,176000,1324,177324,174676,60820971,1260281,95.7,97.9,95.2,93.5,98.2
1776,35620,"New York-Newark-Jersey City, NY-NJ-PA (Metropolitan Statistical Area)",2015,66212,398800,663,399463,398137,1279279091,19320968,122,109,155.3,117.8,125.2
1777,35660,"Niles, MI (Metropolitan Statistical Area)",2015,42553,132600,3305,135905,129295,6596620,155022,88.5,96.3,68.7,92.3,90.8
1778,35840,"North Port-Sarasota-Bradenton, FL (Metropolitan Statistical Area)",2015,51503,175100,2602,177702,172498,39518980,767309,99,98.2,109.6,93.5,101.6
1779,35980,"Norwich-New London, CT (Metropolitan Statistical Area)",2015,53819,244000,3027,247027,240973,14511658,269636,101.4,98.1,107.4,101.8,104
1780,36100,"Ocala, FL (Metropolitan Statistical Area)",2015,33591,111000,3039,114039,107961,11494178,342182,90.3,98.2,75.2,93.5,92.7
1781,36140,"Ocean City, NJ (Metropolitan Statistical Area)",2015,54054,299700,6542,306242,293158,5089757,94160,106.2,100.6,112.6,107.5,109
1782,36220,"Odessa, TX (Metropolitan Statistical Area)",2015,42026,103200,3614,106814,99586,6720151,159903,97.7,98.2,105.4,93.5,100.2
1783,36260,"Ogden-Clearfield, UT (Metropolitan Statistical Area)",2015,38896,199300,1665,200965,197635,24906466,640334,94.8,95.6,83.7,100.9,97.2
1784,36420,"Oklahoma City, OK (Metropolitan Statistical Area)",2015,45323,137200,818,138018,136382,61511862,1357178,92.1,97.9,79.2,93.5,94.5
1785,36500,"Olympia-Lacey-Tumwater, WA (Metropolitan Statistical Area)",2015,45768,239400,2421,241821,236979,12264741,267978,106.9,107.3,111.4,104,109.7
1786,36540,"Omaha-Council Bluffs, NE-IA (Metropolitan Statistical Area)",2015,53835,148200,864,149064,147336,49154914,913073,92.6,96.2,85.6,92.2,95
1787,36740,"Orlando-Kissimmee-Sanford, FL (Metropolitan Statistical Area)",2015,39216,157900,1053,158953,156847,93667702,2388509,98,98.2,104.3,93.5,100.5
1788,36780,"Oshkosh-Neenah, WI (Metropolitan Statistical Area)",2015,43622,143100,2001,145101,141099,7382861,169246,90.2,96.3,75.2,92.3,92.5
1789,36980,"Owensboro, KY (Metropolitan Statistical Area)",2015,39723,112700,2701,115401,109999,4668270,117521,87.7,97.5,62.7,93.5,89.9
1790,37100,"Oxnard-Thousand Oaks-Ventura, CA (Metropolitan Statistical Area)",2015,55534,458100,3239,461339,454861,46970746,845802,116.3,100.9,171.5,106.8,119.3
1791,37340,"Palm Bay-Melbourne-Titusville, FL (Metropolitan Statistical Area)",2015,40962,142200,2060,144260,140140,23174169,565746,95.4,98.2,93.6,93.5,97.9
1792,37460,"Panama City, FL (Metropolitan Statistical Area)",2015,40347,156800,2660,159460,154140,7322428,181488,94.2,97.2,90.6,93.6,96.7
1793,37620,"Parkersburg-Vienna, WV (Metropolitan Statistical Area)",2015,38169,104900,3185,108085,101715,3516873,92139,86.1,97.9,58.2,93.5,88.3
1794,37860,"Pensacola-Ferry Pass-Brent, FL (Metropolitan Statistical Area)",2015,39683,135400,2267,137667,133133,18870868,475537,93.1,98.2,84.5,93.5,95.5
1795,37900,"Peoria, IL (Metropolitan Statistical Area)",2015,45412,131300,1667,132967,129633,18748639,412856,90.6,96.2,75.9,92.2,93
1796,37980,"Philadelphia-Camden-Wilmington, PA-NJ-DE-MD (Metropolitan Statistical Area)",2015,58200,236600,617,237217,235983,352507679,6056816,105.7,100.6,111.7,107.5,108.4
1797,38060,"Phoenix-Mesa-Chandler, AZ (Metropolitan Statistical Area)",2015,41538,179100,992,180092,178108,190181102,4578519,97.2,96.3,96.5,98.8,99.7
1798,38220,"Pine Bluff, AR (Metropolitan Statistical Area)",2015,31741,80200,2465,82665,77735,2984313,94022,83.5,97.1,51.8,93.5,85.7
1799,38300,"Pittsburgh, PA (Metropolitan Statistical Area)",2015,51224,132500,753,133253,131747,120261472,2347757,93.6,98.3,78.7,96.2,96.1
1800,38340,"Pittsfield, MA (Metropolitan Statistical Area)",2015,51239,204700,5265,209965,199435,6551281,127858,96.2,98.1,85.1,101.8,98.7
1801,38540,"Pocatello, ID (Metropolitan Statistical Area)",2015,34632,145300,2790,148090,142510,3181685,91871,90,100.2,70.6,93.4,92.3
1802,38860,"Portland-South Portland, ME (Metropolitan Statistical Area)",2015,50605,234400,2067,236467,232333,26609637,525831,102.1,98.4,109.4,102.3,104.7
1803,38900,"Portland-Vancouver-Hillsboro, OR-WA (Metropolitan Statistical Area)",2015,50065,270700,1162,271862,269538,119237395,2381660,100.6,99.1,114.9,95.9,103.2
1804,38940,"Port St. Lucie, FL (Metropolitan Statistical Area)",2015,48575,145000,3353,148353,141647,21996730,452841,95.8,98.2,95.5,93.5,98.3
1805,39300,"Providence-Warwick, RI-MA (Metropolitan Statistical Area)",2015,49417,250700,1476,252176,249224,79706252,1612928,100.1,98.8,98.2,102.8,102.7
1806,39340,"Provo-Orem, UT (Metropolitan Statistical Area)",2015,35610,227100,1476,228576,225624,20768494,583218,96.6,95.2,91.7,101.4,99.1
1807,39380,"Pueblo, CO (Metropolitan Statistical Area)",2015,35475,138600,2586,141186,136014,5782648,163006,91.2,95.2,71.3,101.5,93.5
1808,39460,"Punta Gorda, FL (Metropolitan Statistical Area)",2015,38320,145700,3388,149088,142312,6605642,172382,94.7,98.2,91.1,93.5,97.1
1809,39540,"Racine, WI (Metropolitan Statistical Area)",2015,44935,164600,2736,167336,161864,8747563,194672,93.9,96,84.8,95.8,96.3
1810,39580,"Raleigh-Cary, NC (Metropolitan Statistical Area)",2015,50126,210700,1840,212540,208860,63714458,1271091,95.9,98.2,95.5,93.5,98.4
1811,39660,"Rapid City, SD (Metropolitan Statistical Area)",2015,46048,162100,2331,164431,159769,6209984,134858,90.8,95.6,80.4,91.7,93.2
1812,39740,"Reading, PA (Metropolitan Statistical Area)",2015,45103,168200,1277,169477,166923,18724168,415138,96.6,98.1,86.4,101.8,99.1
1813,39820,"Redding, CA (Metropolitan Statistical Area)",2015,42336,216600,3968,220568,212632,7549180,178314,97.2,95.2,95.1,101.5,99.8
1814,39900,"Reno, NV (Metropolitan Statistical Area)",2015,50752,212600,2976,215576,209624,22652172,446329,98.1,95.2,99.2,101.4,100.7
1815,40060,"Richmond, VA (Metropolitan Statistical Area) *",2015,52072,213000,1234,214234,211766,64916459,1246665,96.2,98,97.6,93.5,98.7
1816,40140,"Riverside-San Bernardino-Ontario, CA (Metropolitan Statistical Area)",2015,36563,245900,1555,247455,244345,163116137,4461227,106.8,100.9,117.2,106.8,109.6
1817,40220,"Roanoke, VA (Metropolitan Statistical Area) *",2015,44142,169000,1763,170763,167237,13823223,313152,91.2,97.3,77.9,93.5,93.6
1818,40340,"Rochester, MN (Metropolitan Statistical Area)",2015,49492,168100,1404,169504,166696,10588011,213933,92.8,95.5,88.2,91.7,95.2
1819,40380,"Rochester, NY (Metropolitan Statistical Area)",2015,46374,133500,686,134186,132814,49949372,1077092,98.7,98.1,94.9,101.8,101.3
1820,40420,"Rockford, IL (Metropolitan Statistical Area)",2015,40335,121100,1679,122779,119421,13743381,340727,89.5,96.3,73.7,92.3,91.9
1821,40580,"Rocky Mount, NC (Metropolitan Statistical Area)",2015,36521,100300,2925,103225,97375,5387946,147529,85.3,98.2,55.3,93.5,87.5
1822,40660,"Rome, GA (Metropolitan Statistical Area)",2015,35509,117100,4296,121396,112804,3415448,96186,80.6,91.5,58.3,93.2,82.7
1823,40900,"Sacramento-Roseville-Folsom, CA (Metropolitan Statistical Area)",2015,51130,286500,1357,287857,285143,115713023,2263121,101.5,95.2,117.3,101.5,104.2
1824,40980,"Saginaw, MI (Metropolitan Statistical Area)",2015,35876,92900,1467,94367,91433,6934995,193305,88.2,96.3,67.1,92.3,90.5
1825,41060,"St. Cloud, MN (Metropolitan Statistical Area)",2015,42736,164000,1516,165516,162484,8351720,195425,91.5,96.3,81.1,92.3,93.9
1826,41100,"St. George, UT (Metropolitan Statistical Area)",2015,33079,212600,6032,218632,206568,5115741,154650,94.3,100.2,87,93.4,96.7
1827,41140,"St. Joseph, MO-KS (Metropolitan Statistical Area)",2015,36221,111500,2280,113780,109220,4590097,126724,87.4,96,65.7,92,89.7
1828,41180,"St. Louis, MO-IL (Metropolitan Statistical Area)",2015,49707,157100,702,157802,156398,139553430,2807503,91.5,94.9,83.3,92.3,93.9
1829,41420,"Salem, OR (Metropolitan Statistical Area)",2015,38242,191100,2285,193385,188815,15603737,408022,94.3,99.1,82.7,95.9,96.7
1830,41500,"Salinas, CA (Metropolitan Statistical Area)",2015,52330,369100,6340,375440,362760,22530852,430552,107.4,95.2,152.1,101.5,110.2
1831,41540,"Salisbury, MD-DE (Metropolitan Statistical Area)",2015,45679,210900,2657,213557,208243,17975862,393526,90.1,91.5,85.3,93.2,92.4
1832,41620,"Salt Lake City, UT (Metropolitan Statistical Area)",2015,45829,231000,1360,232360,229640,53386587,1164912,99,95.4,103.9,101.2,101.6
1833,41660,"San Angelo, TX (Metropolitan Statistical Area)",2015,43058,108600,3814,112414,104786,5183759,120390,94,98.1,87,93.5,96.4
1834,41700,"San Antonio-New Braunfels, TX (Metropolitan Statistical Area)",2015,43357,138400,1027,139427,137373,103156419,2379232,94.5,97.8,90.1,93.5,96.9
1835,41740,"San Diego-Chula Vista-Carlsbad, CA (Metropolitan Statistical Area)",2015,54822,429600,2036,431636,427564,179862110,3280850,116.1,99,165.1,107.2,119.1
1836,41860,"San Francisco-Oakland-Berkeley, CA (Metropolitan Statistical Area)",2015,82639,617000,2424,619424,614576,384100926,4647924,125.5,112.1,185.6,113.3,128.7
1837,41940,"San Jose-Sunnyvale-Santa Clara, CA (Metropolitan Statistical Area)",2015,85012,688500,3479,691979,685021,167855808,1974501,128.1,111.8,207,113,131.4
1838,42020,"San Luis Obispo-Paso Robles, CA (Metropolitan Statistical Area)",2015,51804,445700,6177,451877,439523,14509065,280077,106.3,95.2,145.4,101.5,109.1
1839,42100,"Santa Cruz-Watsonville, CA (Metropolitan Statistical Area)",2015,59414,578800,9843,588643,568957,16249937,273503,125.3,112.1,172.5,113.3,128.6
1840,42140,"Santa Fe, NM (Metropolitan Statistical Area)",2015,51942,275200,5006,280206,270194,7692465,148098,99.1,95.2,104.4,101.5,101.7
1841,42200,"Santa Maria-Santa Barbara, CA (Metropolitan Statistical Area)",2015,57042,465300,14976,480276,450324,25225688,442229,108.5,95.2,165.5,101.5,111.3
1842,42220,"Santa Rosa-Petaluma, CA (Metropolitan Statistical Area)",2015,55437,436400,4485,440885,431915,27766194,500863,121.6,112.1,152.1,113.3,124.7
1843,42340,"Savannah, GA (Metropolitan Statistical Area)",2015,43155,168800,2094,170894,166706,16305295,377827,93.8,98.2,86.9,93.5,96.3
1844,42540,"Scranton--Wilkes-Barre, PA (Metropolitan Statistical Area)",2015,41690,133000,1567,134567,131433,23251752,557734,93,98.1,72.4,101.8,95.4
1845,42660,"Seattle-Tacoma-Bellevue, WA (Metropolitan Statistical Area)",2015,63685,321400,1277,322677,320123,238160804,3739654,110.4,107.3,130.9,104,113.2
1846,42680,"Sebastian-Vero Beach, FL (Metropolitan Statistical Area)",2015,68566,157800,3696,161496,154104,10108919,147434,91.3,91.5,89.2,93.2,93.7
1847,42700,"Sebring-Avon Park, FL (Metropolitan Statistical Area)",2015,31817,85200,2897,88097,82303,3186066,100137,81.7,91.5,64.9,93.2,83.8
1848,43100,"Sheboygan, WI (Metropolitan Statistical Area)",2015,47340,148200,1887,150087,146313,5453389,115196,90,96.3,73.7,92.3,92.3
1849,43300,"Sherman-Denison, TX (Metropolitan Statistical Area)",2015,38777,107000,2950,109950,104050,4871518,125628,91.4,98.2,76.1,93.5,93.7
1850,43340,"Shreveport-Bossier City, LA (Metropolitan Statistical Area)",2015,44748,127600,3106,130706,124494,18078039,404000,90.2,97.9,73.2,93.5,92.5
1851,43420,"Sierra Vista-Douglas, AZ (Metropolitan Statistical Area)",2015,36934,143900,5108,149008,138792,4670449,126454,90.1,100.2,72.9,93.4,92.4
1852,43580,"Sioux City, IA-NE-SD (Metropolitan Statistical Area)",2015,45877,110900,2108,113008,108792,6594134,143736,88.3,95.2,66.4,91.5,90.6
1853,43620,"Sioux Falls, SD (Metropolitan Statistical Area)",2015,55045,160300,1291,161591,159009,13761971,250012,91.3,96.2,79.9,92.2,93.6
1854,43780,"South Bend-Mishawaka, IN-MI (Metropolitan Statistical Area)",2015,43088,116100,1572,117672,114528,13775245,319703,88.4,95.9,70.6,91.9,90.7
1855,43900,"Spartanburg, SC (Metropolitan Statistical Area)",2015,39674,118200,1795,119995,116405,11765741,296558,87.6,97.8,64.1,93.5,89.9
1856,44060,"Spokane-Spokane Valley, WA (Metropolitan Statistical Area)",2015,41179,182200,2005,184205,180195,21913899,532163,94.9,96,84,100.2,97.3
1857,44100,"Springfield, IL (Metropolitan Statistical Area)",2015,44392,130700,1783,132483,128917,9377951,211254,89.9,96.3,71.9,92.3,92.3
1858,44140,"Springfield, MA (Metropolitan Statistical Area)",2015,47853,214100,2007,216107,212093,33530052,700688,98.4,98.1,93.8,101.9,100.9
1859,44180,"Springfield, MO (Metropolitan Statistical Area)",2015,37771,129500,1376,130876,128124,17208341,455593,87.3,96.1,67,92.1,89.6
1860,44220,"Springfield, OH (Metropolitan Statistical Area)",2015,37138,103600,2108,105708,101492,5041325,135746,86.9,96.3,62.9,92.3,89.2
1861,44300,"State College, PA (Metropolitan Statistical Area)",2015,41699,197200,4271,201471,192929,6691308,160466,103.2,98.1,115.9,101.8,105.9
1862,44420,"Staunton, VA (Metropolitan Statistical Area) *",2015,40785,183400,3488,186888,179912,4894981,120019,87.6,91.5,77.6,93.2,89.9
1863,44700,"Stockton, CA (Metropolitan Statistical Area)",2015,40129,223000,2709,225709,220291,28984215,722271,99.4,95.2,105.5,101.5,102
1864,44940,"Sumter, SC (Metropolitan Statistical Area)",2015,34235,107100,4328,111428,102772,4833330,141180,87.8,98.2,66.2,93.5,90
1865,45060,"Syracuse, NY (Metropolitan Statistical Area)",2015,44673,126700,1499,128199,125201,29379268,657648,96.9,98.1,87.2,101.8,99.5
1866,45220,"Tallahassee, FL (Metropolitan Statistical Area)",2015,38255,164700,2021,166721,162679,14445064,377602,93.3,97.6,86,93.5,95.8
1867,45300,"Tampa-St. Petersburg-Clearwater, FL (Metropolitan Statistical Area)",2015,43142,144600,944,145544,143656,128732079,2983928,98.7,95.3,102.8,100.4,101.2
1868,45460,"Terre Haute, IN (Metropolitan Statistical Area)",2015,34401,88200,1644,89844,86556,6445595,187365,86.7,96,64,92,88.9
1869,45500,"Texarkana, TX-AR (Metropolitan Statistical Area)",2015,35329,96400,2892,99292,93508,5272586,149244,87,96.8,59.4,93.6,89.2
1870,45540,"The Villages, FL (Metropolitan Statistical Area)",2015,40155,213900,4992,218892,208908,4701159,117076,91.5,91.5,90.4,93.2,93.9
1871,45780,"Toledo, OH (Metropolitan Statistical Area)",2015,42924,114700,1130,115830,113570,27727479,645973,88.2,96.3,67.4,92.3,90.5
1872,45820,"Topeka, KS (Metropolitan Statistical Area)",2015,41719,120400,1558,121958,118842,9742182,233520,88.6,95.7,70.5,91.8,90.9
1873,45940,"Trenton-Princeton, NJ (Metropolitan Statistical Area)",2015,63526,276500,3502,280002,272998,23385625,368124,112.1,101.8,123.6,116.1,115
1874,46060,"Tucson, AZ (Metropolitan Statistical Area)",2015,39071,159900,1136,161036,158764,39426771,1009103,96,95.2,89.5,101.5,98.5
1875,46140,"Tulsa, OK (Metropolitan Statistical Area)",2015,54254,131400,988,132388,130412,53219011,980926,91,98,74.6,93.5,93.4
1876,46220,"Tuscaloosa, AL (Metropolitan Statistical Area)",2015,35433,146000,3133,149133,142867,8825045,249066,88.2,96.8,65.8,93.6,90.5
1877,46300,"Twin Falls, ID (Metropolitan Statistical Area)",2015,36846,145500,3315,148815,142185,3876830,105216,91.1,100.2,74.8,93.4,93.4
1878,46340,"Tyler, TX (Metropolitan Statistical Area)",2015,47229,130600,3616,134216,126984,10503359,222390,94,98.2,87.1,93.5,96.4
1879,46520,"Urban Honolulu, HI (Metropolitan Statistical Area)",2015,53205,580200,3505,583705,576695,52729171,991064,124.9,114,179.4,107.7,128.2
1880,46540,"Utica-Rome, NY (Metropolitan Statistical Area)",2015,39688,109900,1725,111625,108175,11664948,293916,94.3,98.1,76.9,101.8,96.7
1881,46660,"Valdosta, GA (Metropolitan Statistical Area)",2015,33173,122900,3643,126543,119257,4754124,143311,81.2,91.5,62.5,93.2,83.3
1882,46700,"Vallejo, CA (Metropolitan Statistical Area)",2015,45179,279100,2749,281849,276351,19580778,433409,118.8,112.1,137.4,113.3,121.9
1883,47020,"Victoria, TX (Metropolitan Statistical Area)",2015,44747,119000,4119,123119,114881,4459036,99649,94.1,97.8,87.8,93.5,96.5
1884,47220,"Vineland-Bridgeton, NJ (Metropolitan Statistical Area)",2015,36916,162400,2326,164726,160074,5711423,154712,99.6,100.6,88.4,107.5,102.2
1885,47260,"Virginia Beach-Norfolk-Newport News, VA-NC (Metropolitan Statistical Area) *",2015,46478,233800,1133,234933,232667,81630793,1756340,98.1,98.1,105.3,93.5,100.6
1886,47300,"Visalia, CA (Metropolitan Statistical Area)",2015,37200,162700,2032,164732,160668,17006585,457161,94.5,95.2,83.3,101.5,97
1887,47380,"Waco, TX (Metropolitan Statistical Area)",2015,37246,110800,2429,113229,108371,9783001,262660,91.6,97.4,77.5,93.6,93.9
1888,47460,"Walla Walla, WA (Metropolitan Statistical Area)",2015,41511,188700,7712,196412,180988,2487812,59932,94.3,100.3,85.4,93.3,96.8
1889,47580,"Warner Robins, GA (Metropolitan Statistical Area)",2015,39100,130300,3151,133451,127149,6893138,176293,89.6,97.4,70.6,93.6,91.9
1890,47900,"Washington-Arlington-Alexandria, DC-VA-MD-WV (Metropolitan Statistical Area) *",2015,65961,378400,924,379324,377476,401961093,6093950,118.7,105.7,168.8,109.4,121.8
1891,47940,"Waterloo-Cedar Falls, IA (Metropolitan Statistical Area)",2015,41840,133300,1714,135014,131586,7148387,170852,90,95.7,76.1,91.8,92.3
1892,48060,"Watertown-Fort Drum, NY (Metropolitan Statistical Area)",2015,43414,141000,3821,144821,137179,5052093,116371,99.3,98.1,98.2,101.8,101.9
1893,48140,"Wausau-Weston, WI (Metropolitan Statistical Area)",2015,44691,144500,1782,146282,142718,7292737,163181,90.1,96.3,72.8,92.3,92.5
1894,48260,"Weirton-Steubenville, WV-OH (Metropolitan Statistical Area)",2015,36607,86400,1499,87899,84901,4417235,120665,84.5,96.3,53.8,92.3,86.7
1895,48300,"Wenatchee, WA (Metropolitan Statistical Area)",2015,43887,232000,4905,236905,227095,5072711,115586,95.3,100.2,90.1,93.4,97.8
1896,48540,"Wheeling, WV-OH (Metropolitan Statistical Area)",2015,40420,96300,2212,98512,94088,5826757,144157,86.1,98.2,56.4,93.5,88.3
1897,48620,"Wichita, KS (Metropolitan Statistical Area)",2015,47227,124400,1253,125653,123147,30015168,635551,89.6,96.1,72.7,92.2,91.9
1898,48660,"Wichita Falls, TX (Metropolitan Statistical Area)",2015,40827,90100,1993,92093,88107,6127379,150083,90,97.8,73.1,93.5,92.3
1899,48700,"Williamsport, PA (Metropolitan Statistical Area)",2015,40586,138500,2488,140988,136012,4691708,115598,94,98.1,76.9,101.8,96.4
1900,48900,"Wilmington, NC (Metropolitan Statistical Area)",2015,40550,200200,4612,204812,195588,11226224,276848,94.1,97.3,89.6,93.5,96.5
1901,49020,"Winchester, VA-WV (Metropolitan Statistical Area) *",2015,43209,205700,6120,211820,199580,5802324,134284,91.5,91.5,89.5,93.2,93.9
1902,49180,"Winston-Salem, NC (Metropolitan Statistical Area)",2015,41202,143000,1310,144310,141690,27039727,656277,89.5,98.2,69,93.5,91.8
1903,49340,"Worcester, MA-CT (Metropolitan Statistical Area)",2015,50457,244400,1453,245853,242947,47157582,934604,104.1,101.7,104.4,106.5,106.8
1904,49420,"Yakima, WA (Metropolitan Statistical Area)",2015,39372,158200,2252,160452,155948,9756483,247800,93.9,95.2,79.2,101.5,96.3
1905,49620,"York-Hanover, PA (Metropolitan Statistical Area)",2015,44806,168400,1170,169570,167230,19792567,441741,97.3,98.1,88.6,101.8,99.8
1906,49660,"Youngstown-Warren-Boardman, OH-PA (Metropolitan Statistical Area)",2015,38969,98900,972,99872,97928,21386119,548798,87.2,96.6,61.2,94.2,89.4
1907,49700,"Yuba City, CA (Metropolitan Statistical Area)",2015,40000,184800,4910,189710,179890,6773110,169327,97.8,95.2,97.5,101.5,100.3
1908,49740,"Yuma, AZ (Metropolitan Statistical Area) *",2015,31364,112100,2202,114302,109898,6435455,205186,92.1,95.2,74.6,101.5,94.5
1909,10180,"Abilene, TX (Metropolitan Statistical Area)",2014,41642,91900,2825,94725,89075,7010125,168342,91.2,97.2,77.8,93.5,93.5
1910,10420,"Akron, OH (Metropolitan Statistical Area)",2014,43724,137600,1287,138887,136313,30821441,704908,90.1,95.6,77.9,90.8,92.3
1911,10500,"Albany, GA (Metropolitan Statistical Area)",2014,34014,103900,3522,107422,100378,5168357,151949,84.1,97.1,55,93.5,86.1
1912,10540,"Albany-Lebanon, OR (Metropolitan Statistical Area)",2014,36066,171700,2939,174639,168761,4293341,119042,94.8,99.4,88.4,94.4,97.1
1913,10580,"Albany-Schenectady-Troy, NY (Metropolitan Statistical Area)",2014,50214,196800,1296,198096,195504,44093361,878113,100.4,98.1,104.6,100.7,102.8
1914,10740,"Albuquerque, NM (Metropolitan Statistical Area) *",2014,37466,177100,1541,178641,175559,33889057,904538,96.8,95.5,91.3,101.9,99.2
1915,10780,"Alexandria, LA (Metropolitan Statistical Area)",2014,39117,115900,3715,119615,112185,6045886,154558,88.6,97.4,67.2,93.4,90.8
1916,10900,"Allentown-Bethlehem-Easton, PA-NJ (Metropolitan Statistical Area)",2014,46503,202900,1561,204461,201339,38526707,828470,101.1,98.7,102.6,103,103.6
1917,11020,"Altoona, PA (Metropolitan Statistical Area)",2014,39901,108500,2554,111054,105946,4998509,125274,90.6,98.1,63.7,100.7,92.9
1918,11100,"Amarillo, TX (Metropolitan Statistical Area)",2014,42717,118500,1727,120227,116773,11141029,260812,92.9,97.7,82.6,93.4,95.1
1919,11180,"Ames, IA (Metropolitan Statistical Area)",2014,39539,164200,2814,167014,161386,4827359,122092,91,93,89.3,90.1,93.2
1920,11260,"Anchorage, AK (Metropolitan Statistical Area)",2014,57537,268200,2435,270635,265765,22899316,397996,108.7,101.8,147.6,100.1,111.3
1921,11460,"Ann Arbor, MI (Metropolitan Statistical Area)",2014,49562,199200,2541,201741,196659,17843290,360021,101.4,98.4,113.7,99.2,103.9
1922,11500,"Anniston-Oxford, AL (Metropolitan Statistical Area)",2014,33090,103300,3506,106806,99794,3835683,115917,84.2,98,52.5,93.4,86.3
1923,11540,"Appleton, WI (Metropolitan Statistical Area)",2014,44713,158400,1557,159957,156843,10356656,231627,92.2,97.3,78.5,93.4,94.4
1924,11700,"Asheville, NC (Metropolitan Statistical Area)",2014,38521,179700,2852,182552,176848,16936240,439661,93.1,96,88.1,93.5,95.4
1925,12020,"Athens-Clarke County, GA (Metropolitan Statistical Area)",2014,34813,158600,2767,161367,155833,6905518,198361,91.9,97.7,80.6,93.4,94.2
1926,12060,"Atlanta-Sandy Springs-Alpharetta, GA (Metropolitan Statistical Area)",2014,44744,167400,682,168082,166718,250262945,5593204,96.1,98.5,91.9,96,98.5
1927,12100,"Atlantic City-Hammonton, NJ (Metropolitan Statistical Area)",2014,43636,230200,3257,233457,226943,11894228,272578,106,101.2,110.8,107.6,108.6
1928,12220,"Auburn-Opelika, AL (Metropolitan Statistical Area)",2014,33176,150100,4121,154221,145979,5126011,154511,86.1,91.2,73.4,93.5,88.2
1929,12260,"Augusta-Richmond County, GA-SC (Metropolitan Statistical Area)",2014,36543,125900,2110,128010,123790,21306042,583046,88.8,97.5,69,93.5,91
1930,12420,"Austin-Round Rock-Georgetown, TX (Metropolitan Statistical Area)",2014,50029,196500,1493,197993,195007,97179427,1942467,99,98,112.6,93.4,101.5
1931,12540,"Bakersfield, CA (Metropolitan Statistical Area)",2014,37407,161800,1782,163582,160018,32513120,869176,97.4,95.5,93.9,102,99.8
1932,12580,"Baltimore-Columbia-Towson, MD (Metropolitan Statistical Area)",2014,54240,277600,1111,278711,276489,150789783,2780055,107.4,102.8,117.6,105.1,110.1
1933,12620,"Bangor, ME (Metropolitan Statistical Area)",2014,36430,137700,2591,140291,135109,5581170,153201,96.9,98.1,89.8,100.7,99.3
1934,12700,"Barnstable Town, MA (Metropolitan Statistical Area)",2014,62087,362800,3330,366130,359470,13304509,214289,103,98.1,116.5,100.7,105.5
1935,12940,"Baton Rouge, LA (Metropolitan Statistical Area)",2014,42965,158600,1370,159970,157230,36384121,846827,93.1,96.7,86.1,93.5,95.4
1936,12980,"Battle Creek, MI (Metropolitan Statistical Area)",2014,35120,97100,1873,98973,95227,4734379,134804,90.8,97.3,74.9,93.4,93.1
1937,13020,"Bay City, MI (Metropolitan Statistical Area)",2014,36620,93300,1688,94988,91612,3883372,106046,89.3,97.3,68.7,93.4,91.5
1938,13140,"Beaumont-Port Arthur, TX (Metropolitan Statistical Area)",2014,40607,95500,1411,96911,94089,15903939,391651,90.1,97.6,70.8,93.5,92.3
1939,13220,"Beckley, WV (Metropolitan Statistical Area)",2014,34305,86900,2763,89663,84137,4231288,123342,78.9,91.2,52.5,93.5,80.8
1940,13380,"Bellingham, WA (Metropolitan Statistical Area)",2014,42153,273000,4079,277079,268921,8774297,208154,99.7,95.5,105.4,102,102.2
1941,13460,"Bend, OR (Metropolitan Statistical Area)",2014,43320,243400,6444,249844,236956,7343291,169512,96.9,99.4,96.3,94.4,99.2
1942,13740,"Billings, MT (Metropolitan Statistical Area)",2014,46621,187100,2606,189706,184494,8156468,174952,97.3,95.7,93.2,101.6,99.6
1943,13780,"Binghamton, NY (Metropolitan Statistical Area)",2014,39032,108800,1748,110548,107052,9643906,247075,95.7,98.1,84,100.7,98.1
1944,13820,"Birmingham-Hoover, AL (Metropolitan Statistical Area)",2014,44169,144000,1616,145616,142384,47530078,1076087,89.6,97.6,70,93.4,91.8
1945,13900,"Bismarck, ND (Metropolitan Statistical Area)",2014,55858,171000,2150,173150,168850,6823362,122155,93.5,97.1,85.4,93.3,95.8
1946,13980,"Blacksburg-Christiansburg, VA (Metropolitan Statistical Area) *",2014,33355,159300,2970,162270,156330,5526496,165688,88.3,91.1,77.6,93.6,90.5
1947,14010,"Bloomington, IL (Metropolitan Statistical Area)",2014,43704,154000,2088,156088,151912,7609034,174105,93.8,96.8,87.7,93.1,96.1
1948,14020,"Bloomington, IN (Metropolitan Statistical Area)",2014,34758,150800,3292,154092,147508,5714971,164422,94.7,97,93.1,93.1,97
1949,14100,"Bloomsburg-Berwick, PA (Metropolitan Statistical Area)",2014,39255,142000,3557,145557,138443,3357763,85538,93.7,98.1,76.1,100.7,96
1950,14260,"Boise City, ID (Metropolitan Statistical Area)",2014,39548,164400,1603,166003,162797,26205717,662624,94.9,95.6,82.2,101.8,97.2
1951,14460,"Boston-Cambridge-Newton, MA-NH (Metropolitan Statistical Area)",2014,65330,363600,966,364566,362634,310116458,4746931,110.2,101.4,139.9,107.4,112.9
1952,14500,"Boulder, CO (Metropolitan Statistical Area) *",2014,60575,358000,4862,362862,353138,18913629,312233,108.8,100.6,141.7,99.6,111.5
1953,14540,"Bowling Green, KY (Metropolitan Statistical Area)",2014,33327,124300,2447,126747,121853,5553337,166630,85.9,91,66.4,93.7,88
1954,14740,"Bremerton-Silverdale-Port Orchard, WA (Metropolitan Statistical Area)",2014,47733,259000,3612,262612,255388,12094971,253387,106.3,106.4,111.4,103.8,108.9
1955,14860,"Bridgeport-Stamford-Norwalk, CT (Metropolitan Statistical Area)",2014,102631,422400,3717,426117,418683,96903612,944196,118.9,110.5,145.5,117.1,121.8
1956,15180,"Brownsville-Harlingen, TX (Metropolitan Statistical Area)",2014,25861,77400,1192,78592,76208,10836016,419005,84.9,98,58.3,93.4,87
1957,15260,"Brunswick, GA (Metropolitan Statistical Area)",2014,35064,130900,7030,137930,123870,4018568,114607,85.8,91.2,72.5,93.5,87.9
1958,15380,"Buffalo-Cheektowaga, NY (Metropolitan Statistical Area)",2014,43426,122600,675,123275,121925,49290908,1135060,94.6,98.1,78.5,100.7,97
1959,15500,"Burlington, NC (Metropolitan Statistical Area)",2014,35661,135800,3262,139062,132538,5541165,155384,90.2,98,72.8,93.4,92.4
1960,15540,"Burlington-South Burlington, VT (Metropolitan Statistical Area)",2014,51108,252000,2924,254924,249076,11022854,215676,103.9,98.1,122.8,100.7,106.5
1961,15680,"California-Lexington Park, MD (Metropolitan Statistical Area)",2014,50585,300200,6013,306213,294187,5559929,109913,98.9,91.2,117.9,93.5,101.3
1962,15940,"Canton-Massillon, OH (Metropolitan Statistical Area)",2014,39875,120900,1238,122138,119662,16096415,403675,88.9,97.3,65.5,93.4,91.1
1963,15980,"Cape Coral-Fort Myers, FL (Metropolitan Statistical Area)",2014,44533,150000,2663,152663,147337,30159057,677232,94.9,98,91.9,93.4,97.3
1964,16020,"Cape Girardeau, MO-IL (Metropolitan Statistical Area)",2014,37583,123700,3524,127224,120176,3660776,97405,84.2,93,66.5,90.1,86.2
1965,16060,"Carbondale-Marion, IL (Metropolitan Statistical Area)",2014,36001,98800,3114,101914,95686,5027783,139658,84.7,93,67.9,90.1,86.7
1966,16180,"Carson City, NV (Metropolitan Statistical Area)",2014,42501,188000,7457,195457,180543,2298527,54082,96.7,99.4,95.8,94.4,99.1
1967,16220,"Casper, WY (Metropolitan Statistical Area)",2014,70433,183100,3122,186222,179978,5731628,81377,97.6,95.5,94.8,102,100
1968,16300,"Cedar Rapids, IA (Metropolitan Statistical Area)",2014,46711,144000,1544,145544,142456,12345774,264300,90.1,96.8,72,93,92.3
1969,16540,"Chambersburg-Waynesboro, PA (Metropolitan Statistical Area)",2014,40923,174300,2399,176699,171901,6245112,152607,95.3,98.1,81.2,100.7,97.6
1970,16580,"Champaign-Urbana, IL (Metropolitan Statistical Area)",2014,43343,142100,2166,144266,139934,9724101,224351,93,96.9,85.5,93.1,95.3
1971,16620,"Charleston, WV (Metropolitan Statistical Area)",2014,39550,97700,1892,99592,95808,10821159,273606,88.5,97.5,63.9,93.4,90.6
1972,16700,"Charleston-North Charleston, SC (Metropolitan Statistical Area)",2014,43130,186700,2228,188928,184472,31348392,726836,96.2,98,97.2,93.4,98.5
1973,16740,"Charlotte-Concord-Gastonia, NC-SC (Metropolitan Statistical Area)",2014,44225,164900,831,165731,164069,106161415,2400483,93.5,97.5,85.5,93.4,95.7
1974,16820,"Charlottesville, VA (Metropolitan Statistical Area) *",2014,54040,260300,4388,264688,255912,11304444,209187,97.8,97,108.6,93.5,100.2
1975,16860,"Chattanooga, TN-GA (Metropolitan Statistical Area)",2014,40114,143200,1754,144954,141446,21829510,544183,90.2,97.7,72.8,93.4,92.4
1976,16940,"Cheyenne, WY (Metropolitan Statistical Area)",2014,49300,186600,3336,189936,183264,4734579,96036,97.1,95.5,92.4,102,99.5
1977,16980,"Chicago-Naperville-Elgin, IL-IN-WI (Metropolitan Statistical Area)",2014,52697,217300,623,217923,216677,503802066,9560430,103.8,100.3,116.1,101.8,106.3
1978,17020,"Chico, CA (Metropolitan Statistical Area)",2014,38053,220100,4098,224198,216002,8505555,223516,99.7,95.5,105,102,102.1
1979,17140,"Cincinnati, OH-KY-IN (Metropolitan Statistical Area)",2014,46559,152600,803,153403,151797,101134873,2172190,89.9,94.7,78.9,91.1,92.1
1980,17300,"Clarksville, TN-KY (Metropolitan Statistical Area)",2014,37964,135600,2298,137898,133302,10995388,289628,91,97.7,78.1,93.4,93.3
1981,17420,"Cleveland, TN (Metropolitan Statistical Area)",2014,35080,137600,3577,141177,134023,4190490,119455,84.5,91.2,67.7,93.5,86.6
1982,17460,"Cleveland-Elyria, OH (Metropolitan Statistical Area)",2014,46924,139800,708,140508,139092,97007796,2067356,90.3,95.6,79.4,90.8,92.5
1983,17660,"Coeur d'Alene, ID (Metropolitan Statistical Area)",2014,38404,184200,4548,188748,179652,5627290,146529,93.8,99.4,84.6,94.4,96.1
1984,17780,"College Station-Bryan, TX (Metropolitan Statistical Area)",2014,35840,143000,3500,146500,139500,8702990,242830,93.9,97.3,88.9,93.4,96.2
1985,17820,"Colorado Springs, CO (Metropolitan Statistical Area)",2014,43231,215300,2013,217313,213287,29680492,686562,99.4,95.6,103.7,101.8,101.8
1986,17860,"Columbia, MO (Metropolitan Statistical Area)",2014,41232,165900,2819,168719,163081,8266587,200492,92.5,97.3,81.5,93.4,94.8
1987,17900,"Columbia, SC (Metropolitan Statistical Area)",2014,39323,138500,1321,139821,137179,31414723,798882,91.8,97.4,79.5,93.4,94
1988,17980,"Columbus, GA-AL (Metropolitan Statistical Area)",2014,35355,134700,2938,137638,131762,11499993,325273,89.2,97.9,70.9,93.4,91.4
1989,18020,"Columbus, IN (Metropolitan Statistical Area)",2014,44633,135900,3307,139207,132593,3592794,80497,88.5,93,79.1,90.1,90.6
1990,18140,"Columbus, OH (Metropolitan Statistical Area)",2014,45431,158000,889,158889,157111,90936488,2001635,93,97.1,83.8,93.2,95.3
1991,18580,"Corpus Christi, TX (Metropolitan Statistical Area)",2014,43009,108500,1792,110292,106708,18206109,423313,93.2,97.7,84.9,93.4,95.5
1992,18700,"Corvallis, OR (Metropolitan Statistical Area)",2014,40277,268400,5838,274238,262562,3512790,87215,99.7,99.4,108.1,94.4,102.1
1993,18880,"Crestview-Fort Walton Beach-Destin, FL (Metropolitan Statistical Area)",2014,45059,177100,4416,181516,172684,11526257,255801,95.1,94.9,98.2,93.8,97.4
1994,19060,"Cumberland, MD-WV (Metropolitan Statistical Area)",2014,35434,120100,3442,123542,116658,3564240,100587,87.5,98,63.5,93.4,89.6
1995,19100,"Dallas-Fort Worth-Arlington, TX (Metropolitan Statistical Area)",2014,49866,151900,701,152601,151199,343563993,6889769,99.8,99.2,100.6,100.1,102.3
1996,19140,"Dalton, GA (Metropolitan Statistical Area)",2014,31202,110900,3400,114300,107500,4439929,142298,84.1,91.2,66.1,93.5,86.1
1997,19180,"Danville, IL (Metropolitan Statistical Area)",2014,35746,75200,1912,77112,73288,2851937,79783,81.2,93,57.9,90.1,83.2
1998,19300,"Daphne-Fairhope-Foley, AL (Metropolitan Statistical Area)",2014,39602,168800,3288,172088,165512,7887975,199183,92,98,82.6,93.4,94.2
1999,19340,"Davenport-Moline-Rock Island, IA-IL (Metropolitan Statistical Area)",2014,44282,124600,1198,125798,123402,17007198,384070,90.8,97.2,74.1,93.3,93
2000,19460,"Decatur, AL (Metropolitan Statistical Area)",2014,34829,114700,3389,118089,111311,5324861,152888,86.4,98,56.9,93.4,88.5
2001,19500,"Decatur, IL (Metropolitan Statistical Area)",2014,44647,94000,2298,96298,91702,4844861,108515,88.2,97.3,63.7,93.4,90.4
2002,19660,"Deltona-Daytona Beach-Ormond Beach, FL (Metropolitan Statistical Area)",2014,37045,139800,1867,141667,137933,22545746,608604,95.5,98,94.4,93.4,97.8
2003,19740,"Denver-Aurora-Lakewood, CO (Metropolitan Statistical Area) *",2014,55631,253100,1364,254464,251736,153206154,2753973,104.2,100.5,117.5,99.5,106.7
2004,19780,"Des Moines-West Des Moines, IA (Metropolitan Statistical Area)",2014,47949,157800,1124,158924,156676,31149990,649652,94.4,97.2,89.8,93.3,96.7
2005,19820,"Detroit-Warren-Dearborn, MI (Metropolitan Statistical Area)",2014,44995,122800,607,123407,122193,193982040,4311194,96.6,98.4,87.6,99.2,99
2006,20020,"Dothan, AL (Metropolitan Statistical Area)",2014,36347,107400,2505,109905,104895,5373158,147830,84.9,96.6,57.5,93.5,87
2007,20100,"Dover, DE (Metropolitan Statistical Area)",2014,37323,200200,3339,203539,196861,6399294,171456,94.2,98,88.8,93.4,96.5
2008,20220,"Dubuque, IA (Metropolitan Statistical Area)",2014,42973,146500,1996,148496,144504,4146030,96481,92.4,97.3,80.8,93.4,94.6
2009,20260,"Duluth, MN-WI (Metropolitan Statistical Area)",2014,40993,139600,1547,141147,138053,11898558,290261,91.2,97,78.3,93.1,93.4
2010,20500,"Durham-Chapel Hill, NC (Metropolitan Statistical Area)",2014,45886,194100,2427,196527,191673,27496715,599236,95.2,97.8,93.2,93.4,97.6
2011,20700,"East Stroudsburg, PA (Metropolitan Statistical Area)",2014,36666,183100,3927,187027,179173,6133664,167285,99.9,98.1,102,100.7,102.3
2012,20740,"Eau Claire, WI (Metropolitan Statistical Area)",2014,42390,148600,1901,150501,146699,6995248,165023,91.5,97.3,77.1,93.4,93.8
2013,20940,"El Centro, CA (Metropolitan Statistical Area)",2014,35021,145200,5388,150588,139812,6232834,177974,91,99.4,75.6,94.4,93.2
2014,21060,"Elizabethtown-Fort Knox, KY (Metropolitan Statistical Area)",2014,37010,135200,3341,138541,131859,5613460,151675,86.2,91.2,73.9,93.5,88.3
2015,21140,"Elkhart-Goshen, IN (Metropolitan Statistical Area)",2014,38553,122600,2060,124660,120540,7765498,201423,90.5,97.3,73.4,93.4,92.7
2016,21300,"Elmira, NY (Metropolitan Statistical Area)",2014,39518,97800,1953,99753,95847,3445062,87177,95.4,98.1,82.3,100.7,97.7
2017,21340,"El Paso, TX (Metropolitan Statistical Area)",2014,31741,112500,969,113469,111531,26570109,837089,89.9,98,74.5,93.4,92.1
2018,21420,"Enid, OK (Metropolitan Statistical Area)",2014,45208,93500,4911,98411,88589,2838631,62790,88.3,98,64.9,93.4,90.4
2019,21500,"Erie, PA (Metropolitan Statistical Area)",2014,39287,117200,1825,119025,115375,10977709,279423,93.4,98.1,75,100.7,95.7
2020,21660,"Eugene-Springfield, OR (Metropolitan Statistical Area)",2014,38746,214300,2310,216610,211990,13872266,358027,97.9,95.5,96.4,102,100.3
2021,21780,"Evansville, IN-KY (Metropolitan Statistical Area)",2014,41957,121300,1990,123290,119310,13210499,314859,90.2,97.3,70.6,93.4,92.4
2022,21820,"Fairbanks, AK (Metropolitan Statistical Area) *",2014,52174,215000,6306,221306,208694,5178518,99254,107.1,99.4,153.1,94.4,109.7
2023,22020,"Fargo, ND-MN (Metropolitan Statistical Area)",2014,49748,161400,2167,163567,159233,11332101,227790,93,97.3,83.3,93.4,95.3
2024,22140,"Farmington, NM (Metropolitan Statistical Area)",2014,33781,144100,5929,150029,138171,4360632,129084,91.6,99.4,74.5,94.4,93.8
2025,22180,"Fayetteville, NC (Metropolitan Statistical Area)",2014,33587,130500,2362,132862,128138,17150633,510635,91.3,97.4,79.7,93.4,93.5
2026,22220,"Fayetteville-Springdale-Rogers, AR (Metropolitan Statistical Area)",2014,54976,144000,1911,145911,142089,26416796,480513,90.1,97.8,71.2,93.4,92.3
2027,22380,"Flagstaff, AZ (Metropolitan Statistical Area)",2014,40654,217200,7035,224235,210165,5592651,137566,98.9,99.4,105.2,94.4,101.3
2028,22420,"Flint, MI (Metropolitan Statistical Area)",2014,35258,88300,1122,89422,87178,14556448,412859,92.2,98.4,68.9,99.2,94.5
2029,22500,"Florence, SC (Metropolitan Statistical Area)",2014,34946,106100,3033,109133,103067,7213694,206426,85.6,96.5,59,93.5,87.7
2030,22520,"Florence-Muscle Shoals, AL (Metropolitan Statistical Area)",2014,34372,110400,3024,113424,107376,5068568,147462,84,98,50.2,93.4,86.1
2031,22540,"Fond du Lac, WI (Metropolitan Statistical Area)",2014,42214,146200,2115,148315,144085,4304888,101977,88,93,77.4,90.1,90.2
2032,22660,"Fort Collins, CO (Metropolitan Statistical Area)",2014,45152,251600,3156,254756,248444,14629751,324008,101.2,95.5,113.8,102,103.6
2033,22900,"Fort Smith, AR-OK (Metropolitan Statistical Area)",2014,34517,101400,1977,103377,99423,8567881,248220,85.7,97.2,58.3,93.5,87.8
2034,23060,"Fort Wayne, IN (Metropolitan Statistical Area)",2014,40389,114100,1049,115149,113051,16098614,398591,89.9,97.3,69.7,93.4,92.1
2035,23420,"Fresno, CA (Metropolitan Statistical Area)",2014,37872,191700,2802,194502,188898,36378424,960567,96.9,95.5,91.6,102,99.2
2036,23460,"Gadsden, AL (Metropolitan Statistical Area)",2014,32929,100400,3596,103996,96804,3404875,103399,84.3,98,52.3,93.4,86.4
2037,23540,"Gainesville, FL (Metropolitan Statistical Area)",2014,37318,160600,2419,163019,158181,11633583,311743,95.2,97.7,93.4,93.4,97.5
2038,23580,"Gainesville, GA (Metropolitan Statistical Area)",2014,36142,162200,2592,164792,159608,6835910,189142,89.2,91.2,82.2,93.5,91.4
2039,23900,"Gettysburg, PA (Metropolitan Statistical Area)",2014,43022,194100,3292,197392,190808,4360360,101353,96.6,98.1,87.2,100.7,99
2040,24020,"Glens Falls, NY (Metropolitan Statistical Area)",2014,40256,165100,2364,167464,162736,5126289,127341,97.8,98.1,92.6,100.7,100.2
2041,24140,"Goldsboro, NC (Metropolitan Statistical Area)",2014,34781,108000,4376,112376,103624,4333170,124586,87.4,98,63.5,93.4,89.5
2042,24220,"Grand Forks, ND-MN (Metropolitan Statistical Area)",2014,45354,146700,2964,149664,143736,4592567,101260,93.2,97.3,85,93.4,95.5
2043,24260,"Grand Island, NE (Metropolitan Statistical Area)",2014,40202,112200,2290,114490,109910,3024786,75240,85.9,93.1,66.6,90.2,88.1
2044,24300,"Grand Junction, CO (Metropolitan Statistical Area)",2014,40028,203200,4294,207494,198906,5888618,147113,95.1,99.4,89.8,94.4,97.5
2045,24340,"Grand Rapids-Kentwood, MI (Metropolitan Statistical Area)",2014,43378,139100,1029,140129,138071,44950188,1036234,93.3,96.9,85.9,93.1,95.6
2046,24420,"Grants Pass, OR (Metropolitan Statistical Area)",2014,34761,212600,7158,219758,205442,2898306,83377,94.4,99.4,87,94.4,96.7
2047,24500,"Great Falls, MT (Metropolitan Statistical Area)",2014,41970,159900,2293,162193,157607,3443925,82056,93.1,95.5,75.6,102,95.4
2048,24540,"Greeley, CO (Metropolitan Statistical Area) *",2014,42283,196100,2798,198898,193302,11717193,277112,98.1,100.6,92.5,99.6,100.5
2049,24580,"Green Bay, WI (Metropolitan Statistical Area)",2014,45483,156700,1229,157929,155471,14281744,314003,91.6,96.8,78.8,93,93.9
2050,24660,"Greensboro-High Point, NC (Metropolitan Statistical Area)",2014,38672,140000,1347,141347,138653,28868290,746497,90.1,97.5,72.3,93.4,92.3
2051,24780,"Greenville, NC (Metropolitan Statistical Area)",2014,36761,133400,3591,136991,129809,6432153,174974,88.6,98,68,93.4,90.7
2052,24860,"Greenville-Anderson, SC (Metropolitan Statistical Area)",2014,38457,137600,1690,139290,135910,33083695,860285,90,97.7,72.1,93.4,92.2
2053,25060,"Gulfport-Biloxi, MS (Metropolitan Statistical Area)",2014,34630,130400,2741,133141,127659,13984975,403841,90.2,98,74.5,93.4,92.4
2054,25180,"Hagerstown-Martinsburg, MD-WV (Metropolitan Statistical Area)",2014,38856,181200,3011,184211,178189,10753471,276755,101.5,105.7,84.5,110.4,103.9
2055,25220,"Hammond, LA (Metropolitan Statistical Area)",2014,35069,135400,5225,140625,130175,4454100,127010,85.4,91.2,70.6,93.5,87.5
2056,25260,"Hanford-Corcoran, CA (Metropolitan Statistical Area)",2014,33167,170000,3434,173434,166566,4958327,149495,93.5,99.4,83.4,94.4,95.7
2057,25420,"Harrisburg-Carlisle, PA (Metropolitan Statistical Area)",2014,45977,169900,894,170794,169006,25800644,561164,96.9,98.1,88.5,100.7,99.3
2058,25500,"Harrisonburg, VA (Metropolitan Statistical Area) *",2014,35521,198100,4227,202327,193873,4632625,130420,91.4,91.2,89.5,93.5,93.7
2059,25540,"Hartford-East Hartford-Middletown, CT (Metropolitan Statistical Area)",2014,57190,247200,1280,248480,245920,69422681,1213886,101.6,98.3,109.9,101,104.1
2060,25620,"Hattiesburg, MS (Metropolitan Statistical Area)",2014,35051,131100,4200,135300,126900,5859709,167179,84.5,91.2,68.3,93.5,86.5
2061,25860,"Hickory-Lenoir-Morganton, NC (Metropolitan Statistical Area)",2014,33798,120200,1902,122102,118298,12269919,363035,88.3,98,64.4,93.4,90.5
2062,25940,"Hilton Head Island-Bluffton, SC (Metropolitan Statistical Area)",2014,45477,252400,7688,260088,244712,9173833,201725,94.1,91.2,98.5,93.5,96.4
2063,25980,"Hinesville, GA (Metropolitan Statistical Area)",2014,30269,121300,4985,126285,116315,2455416,81120,91.7,91.2,90.7,93.5,94
2064,26140,"Homosassa Springs, FL (Metropolitan Statistical Area)",2014,34362,113500,3494,116994,110006,4770342,138828,88.6,91.2,81.7,93.5,90.8
2065,26300,"Hot Springs, AR (Metropolitan Statistical Area)",2014,35616,130200,4270,134470,125930,3481701,97758,85,91.2,69.8,93.5,87.1
2066,26380,"Houma-Thibodaux, LA (Metropolitan Statistical Area)",2014,45331,132900,3254,136154,129646,9581473,211368,92.6,98,81.2,93.4,94.9
2067,26420,"Houston-The Woodlands-Sugar Land, TX (Metropolitan Statistical Area)",2014,54462,144000,660,144660,143340,354013788,6500199,100.9,96.3,99.8,107.3,103.4
2068,26580,"Huntington-Ashland, WV-KY-OH (Metropolitan Statistical Area)",2014,35315,103400,2070,105470,101330,13029179,368938,86.3,97.8,57.6,93.4,88.4
2069,26620,"Huntsville, AL (Metropolitan Statistical Area)",2014,43545,161000,2016,163016,158984,19176821,440395,90.5,98,70.8,93.4,92.7
2070,26820,"Idaho Falls, ID (Metropolitan Statistical Area)",2014,37187,153400,2671,156071,150729,5125715,137838,89.3,99.4,68.5,94.3,91.5
2071,26900,"Indianapolis-Carmel-Anderson, IN (Metropolitan Statistical Area)",2014,47285,139900,797,140697,139103,93198441,1971006,92.9,97.3,83.5,93.3,95.2
2072,26980,"Iowa City, IA (Metropolitan Statistical Area)",2014,47345,180800,3577,184377,177223,7800591,164759,96,97,99.4,93.1,98.4
2073,27060,"Ithaca, NY (Metropolitan Statistical Area)",2014,39083,171000,2765,173765,168235,4040806,103391,105.8,98.1,132.4,100.7,108.4
2074,27100,"Jackson, MI (Metropolitan Statistical Area)",2014,33950,110500,2275,112775,108225,5412353,159421,90.3,97.3,71.9,93.4,92.5
2075,27140,"Jackson, MS (Metropolitan Statistical Area)",2014,40873,129800,1924,131724,127876,24415921,597357,90.3,97.5,73.4,93.4,92.5
2076,27180,"Jackson, TN (Metropolitan Statistical Area)",2014,35394,108900,2954,111854,105946,6348278,179358,82.8,91.1,60,93.7,84.8
2077,27260,"Jacksonville, FL (Metropolitan Statistical Area)",2014,43191,158300,1148,159448,157152,61177760,1416446,95.9,97.9,96,93.4,98.2
2078,27340,"Jacksonville, NC (Metropolitan Statistical Area)",2014,42494,154100,2929,157029,151171,8151302,191822,94.2,98,89.6,93.4,96.5
2079,27500,"Janesville-Beloit, WI (Metropolitan Statistical Area)",2014,38664,131500,2439,133939,129061,6221732,160920,92,97.3,79,93.4,94.2
2080,27620,"Jefferson City, MO (Metropolitan Statistical Area)",2014,38863,136100,2644,138744,133456,5857669,150727,82.8,93,59.7,90.1,84.9
2081,27740,"Johnson City, TN (Metropolitan Statistical Area)",2014,35466,128500,2970,131470,125530,7093959,200021,88.1,98,64.6,93.4,90.2
2082,27780,"Johnstown, PA (Metropolitan Statistical Area)",2014,37870,86800,1206,88006,85594,5208586,137537,86.1,98.1,50.5,100.7,88.3
2083,27860,"Jonesboro, AR (Metropolitan Statistical Area)",2014,33462,111200,3432,114632,107768,4243452,126813,82,91.2,61.4,93.5,84
2084,27900,"Joplin, MO (Metropolitan Statistical Area)",2014,35251,103800,2369,106169,101431,6199569,175869,87.4,97.3,61.5,93.4,89.5
2085,27980,"Kahului-Wailuku-Lahaina, HI (Metropolitan Statistical Area)",2014,41304,510300,15310,525610,494990,6737768,163125,107.1,99.4,143.5,94.4,109.8
2086,28020,"Kalamazoo-Portage, MI (Metropolitan Statistical Area)",2014,41552,131700,1919,133619,129781,10759987,258951,91.9,97.3,79.1,93.4,94.2
2087,28100,"Kankakee, IL (Metropolitan Statistical Area)",2014,36206,143100,3235,146335,139865,4050847,111883,97.1,100.3,83.5,101.9,99.5
2088,28140,"Kansas City, MO-KS (Metropolitan Statistical Area)",2014,47612,158300,734,159034,157566,98518095,2069182,94.3,96.9,83.8,96.5,96.6
2089,28420,"Kennewick-Richland, WA (Metropolitan Statistical Area)",2014,39179,174000,1881,175881,172119,10741048,274154,97.7,95.5,95.3,102,100.1
2090,28660,"Killeen-Temple, TX (Metropolitan Statistical Area)",2014,38426,120600,1634,122234,118966,16385637,426421,92.6,97.8,83,93.4,94.9
2091,28700,"Kingsport-Bristol, TN-VA (Metropolitan Statistical Area) *",2014,35964,118900,1955,120855,116945,11048091,307198,86.1,98,57.8,93.4,88.2
2092,28740,"Kingston, NY (Metropolitan Statistical Area)",2014,42912,226600,3339,229939,223261,7741306,180400,104.4,98.1,125.6,100.7,107
2093,28940,"Knoxville, TN (Metropolitan Statistical Area)",2014,39911,148200,1469,149669,146731,33242886,832928,90.3,97.2,73.2,93.5,92.5
2094,29020,"Kokomo, IN (Metropolitan Statistical Area)",2014,36935,96200,2125,98325,94075,3051023,82605,86.8,97.3,60.1,93.4,88.9
2095,29100,"La Crosse-Onalaska, WI-MN (Metropolitan Statistical Area)",2014,44090,154700,1880,156580,152820,6002389,136140,92.7,97.3,82.2,93.4,94.9
2096,29180,"Lafayette, LA (Metropolitan Statistical Area)",2014,46060,127400,3180,130580,124220,22333507,484876,88.8,96.8,68.5,93.5,91
2097,29200,"Lafayette-West Lafayette, IN (Metropolitan Statistical Area)",2014,35211,125000,2188,127188,122812,7797240,221445,93.5,96.9,88,93.1,95.8
2098,29340,"Lake Charles, LA (Metropolitan Statistical Area)",2014,41343,118600,2789,121389,115811,8404947,203296,88.7,97.8,67.1,93.4,90.9
2099,29420,"Lake Havasu City-Kingman, AZ (Metropolitan Statistical Area)",2014,28458,124600,3581,128181,121019,5789089,203423,93.2,95.5,77.3,102,95.5
2100,29460,"Lakeland-Winter Haven, FL (Metropolitan Statistical Area)",2014,32643,107100,1594,108694,105506,20708624,634398,93.2,98,85.2,93.4,95.4
2101,29540,"Lancaster, PA (Metropolitan Statistical Area)",2014,44308,187300,1620,188920,185680,23628792,533289,99.6,98.1,100.7,100.7,102
2102,29620,"Lansing-East Lansing, MI (Metropolitan Statistical Area)",2014,36042,129700,1576,131276,128124,19463543,540028,93.4,97.3,85.4,93.4,95.7
2103,29700,"Laredo, TX (Metropolitan Statistical Area)",2014,29218,107400,2082,109482,105318,7814757,267465,88.4,98,68.8,93.4,90.5
2104,29740,"Las Cruces, NM (Metropolitan Statistical Area)",2014,31947,137300,4127,141427,133173,6834492,213933,92.3,95.5,74.1,102,94.6
2105,29820,"Las Vegas-Henderson-Paradise, NV (Metropolitan Statistical Area)",2014,40552,163100,804,163904,162296,83258428,2053134,98.5,95.5,99.1,102,100.9
2106,29940,"Lawrence, KS (Metropolitan Statistical Area)",2014,37756,181300,3873,185173,177427,4396463,116445,94,97.3,88.3,93.4,96.3
2107,30020,"Lawton, OK (Metropolitan Statistical Area)",2014,37987,111800,3601,115401,108199,4972867,130909,90.7,97.2,75.2,93.5,93
2108,30140,"Lebanon, PA (Metropolitan Statistical Area)",2014,40967,164500,1747,166247,162753,5593502,136538,95.8,98.1,84,100.7,98.1
2109,30300,"Lewiston, ID-WA (Metropolitan Statistical Area)",2014,39269,167100,3288,170388,163812,2435923,62031,90.5,99.4,72.1,94.4,92.7
2110,30340,"Lewiston-Auburn, ME (Metropolitan Statistical Area)",2014,36415,152800,2596,155396,150204,3909407,107358,95.7,98.1,84.2,100.7,98
2111,30460,"Lexington-Fayette, KY (Metropolitan Statistical Area)",2014,42809,163000,1367,164367,161633,21196089,495137,92.3,98,78.9,93.4,94.5
2112,30620,"Lima, OH (Metropolitan Statistical Area)",2014,36845,106200,2134,108334,104066,3863118,104848,88.9,97.3,65.9,93.4,91.1
2113,30700,"Lincoln, NE (Metropolitan Statistical Area)",2014,43400,149700,1406,151106,148294,13872083,319634,92.4,97.2,81.2,93.3,94.7
2114,30780,"Little Rock-North Little Rock-Conway, AR (Metropolitan Statistical Area)",2014,41135,136400,1597,137997,134803,29954103,728190,90.5,97.8,73,93.4,92.7
2115,30860,"Logan, UT-ID (Metropolitan Statistical Area)",2014,32497,185700,2814,188514,182886,4250769,130804,90.6,99.4,72.4,94.4,92.8
2116,30980,"Longview, TX (Metropolitan Statistical Area)",2014,41877,109300,2512,111812,106788,11860345,283219,91.4,96.9,78.9,93.5,93.7
2117,31020,"Longview, WA (Metropolitan Statistical Area)",2014,39892,175200,4440,179640,170760,4060597,101790,94.2,99.4,85.9,94.4,96.5
2118,31080,"Los Angeles-Long Beach-Anaheim, CA (Metropolitan Statistical Area)",2014,53450,454200,1110,455310,453090,703756060,13166609,117.5,104.9,165.3,107.1,120.3
2119,31140,"Louisville/Jefferson County, KY-IN (Metropolitan Statistical Area)",2014,43289,148000,990,148990,147010,53650667,1239354,91.1,97.6,75.3,93.4,93.4
2120,31180,"Lubbock, TX (Metropolitan Statistical Area)",2014,38353,107800,1856,109656,105944,11738143,306056,93.3,97.6,84.9,93.5,95.6
2121,31340,"Lynchburg, VA (Metropolitan Statistical Area) *",2014,36611,162000,2483,164483,159517,9443971,257953,90.5,97.7,73.5,93.4,92.7
2122,31420,"Macon-Bibb County, GA (Metropolitan Statistical Area)",2014,36262,120400,2836,123236,117564,8356295,230441,87.3,97.1,63.6,93.5,89.5
2123,31460,"Madera, CA (Metropolitan Statistical Area)",2014,34811,179100,6510,185610,172590,5341934,153456,96.4,95.5,89.9,102,98.8
2124,31540,"Madison, WI (Metropolitan Statistical Area)",2014,50745,217500,1464,218964,216036,32140252,633369,97.4,96.8,107.7,93,99.8
2125,31700,"Manchester-Nashua, NH (Metropolitan Statistical Area)",2014,53327,245900,1867,247767,244033,21718569,407275,108.1,101.2,126.2,107,110.7
2126,31740,"Manhattan, KS (Metropolitan Statistical Area)",2014,41453,166700,4083,170783,162617,5623675,135665,93.7,93,99.6,90.1,96
2127,31860,"Mankato, MN (Metropolitan Statistical Area)",2014,42383,163300,2206,165506,161094,4181936,98670,89.9,93,85.5,90.1,92.2
2128,31900,"Mansfield, OH (Metropolitan Statistical Area)",2014,35139,102400,2268,104668,100132,4286962,121999,86.2,97.3,58.9,93.4,88.3
2129,32580,"McAllen-Edinburg-Mission, TX (Metropolitan Statistical Area)",2014,24347,78900,1405,80305,77495,20203330,829819,85.1,98,58.1,93.4,87.1
2130,32780,"Medford, OR (Metropolitan Statistical Area)",2014,39252,217200,4013,221213,213187,8211135,209189,97.9,95.5,96.4,102,100.3
2131,32820,"Memphis, TN-MS-AR (Metropolitan Statistical Area)",2014,41168,133700,1058,134758,132642,54895161,1333432,91.7,97.7,78.2,93.4,93.9
2132,32900,"Merced, CA (Metropolitan Statistical Area)",2014,35526,152600,2743,155343,149857,9393654,264419,95.1,95.5,84,102,97.4
2133,33100,"Miami-Fort Lauderdale-Pompano Beach, FL (Metropolitan Statistical Area)",2014,48357,188700,1315,190015,187385,285010621,5893858,106.9,100.6,128.7,100.9,109.5
2134,33140,"Michigan City-La Porte, IN (Metropolitan Statistical Area)",2014,37049,124000,3115,127115,120885,4139655,111735,86.7,93,73.2,90.1,88.8
2135,33220,"Midland, MI (Metropolitan Statistical Area)",2014,40912,128000,3339,131339,124661,3415791,83492,91.7,97.3,77.7,93.4,94
2136,33260,"Midland, TX (Metropolitan Statistical Area)",2014,117133,155400,3803,159203,151597,18997438,162187,99.4,97.6,120.6,93.5,101.9
2137,33340,"Milwaukee-Waukesha, WI (Metropolitan Statistical Area)",2014,49482,194700,1015,195715,193685,77934143,1575002,95.6,95.3,96.3,95.5,97.9
2138,33460,"Minneapolis-St. Paul-Bloomington, MN-WI (Metropolitan Statistical Area)",2014,54587,212600,669,213269,211931,189756502,3476192,102.3,103.9,110,96.8,104.8
2139,33540,"Missoula, MT (Metropolitan Statistical Area)",2014,40855,237300,4416,241716,232884,4608495,112801,96.7,99.4,95.5,94.4,99
2140,33660,"Mobile, AL (Metropolitan Statistical Area)",2014,34619,124500,1713,126213,122787,14921414,431017,88.1,98,65.9,93.4,90.2
2141,33700,"Modesto, CA (Metropolitan Statistical Area)",2014,38171,175400,2506,177906,172894,20154943,528015,98.3,95.5,98.5,102,100.7
2142,33740,"Monroe, LA (Metropolitan Statistical Area)",2014,35401,116000,3079,119079,112921,7277295,205570,85.6,97.5,57.3,93.4,87.7
2143,33780,"Monroe, MI (Metropolitan Statistical Area)",2014,39863,137500,3101,140601,134399,5973360,149847,94.9,98.4,80.1,99.2,97.2
2144,33860,"Montgomery, AL (Metropolitan Statistical Area)",2014,38084,128500,2279,130779,126221,14223282,373476,89.5,97.9,70.1,93.4,91.7
2145,34060,"Morgantown, WV (Metropolitan Statistical Area)",2014,37920,144900,5429,150329,139471,5210054,137396,88.5,91.2,79.3,93.5,90.7
2146,34100,"Morristown, TN (Metropolitan Statistical Area)",2014,31844,123700,3674,127374,120026,4403431,138280,81.6,91.2,61.8,93.5,83.6
2147,34580,"Mount Vernon-Anacortes, WA (Metropolitan Statistical Area)",2014,44327,254900,5901,260801,248999,5317757,119966,98.1,99.4,101.7,94.4,100.5
2148,34620,"Muncie, IN (Metropolitan Statistical Area)",2014,32748,88300,1878,90178,86422,3814761,116487,89.1,97.3,70,93.4,91.2
2149,34740,"Muskegon, MI (Metropolitan Statistical Area)",2014,33438,98600,1544,100144,97056,5759862,172254,87.9,97.3,64.7,93.4,90.1
2150,34820,"Myrtle Beach-Conway-North Myrtle Beach, SC-NC (Metropolitan Statistical Area)",2014,33853,163400,1947,165347,161453,14085241,416065,91.1,96.4,83.7,93.5,93.4
2151,34900,"Napa, CA (Metropolitan Statistical Area)",2014,59800,439000,8493,447493,430507,8396221,140405,121,110.9,158.6,111,124
2152,34940,"Naples-Marco Island, FL (Metropolitan Statistical Area)",2014,77435,258400,6324,264724,252076,26886324,347211,99.8,98,117.7,93.4,102.2
2153,34980,"Nashville-Davidson--Murfreesboro--Franklin, TN (Metropolitan Statistical Area)",2014,49204,171700,763,172463,170937,87010427,1768350,93.7,97.6,87,93.4,96
2154,35100,"New Bern, NC (Metropolitan Statistical Area)",2014,39056,149400,4267,153667,145133,4951413,126778,87.1,91.2,76.9,93.5,89.2
2155,35300,"New Haven-Milford, CT (Metropolitan Statistical Area)",2014,50298,250400,1878,252278,248522,43401306,862885,112,107.7,116.2,114,114.7
2156,35380,"New Orleans-Metairie, LA (Metropolitan Statistical Area)",2014,47432,173600,877,174477,172723,59237931,1248905,95.8,97.7,96.1,93.4,98.2
2157,35620,"New York-Newark-Jersey City, NY-NJ-PA (Metropolitan Statistical Area)",2014,63479,400000,800,400800,399200,1223930339,19280929,121.3,109.5,156.1,116,124.2
2158,35660,"Niles, MI (Metropolitan Statistical Area)",2014,40036,130700,2655,133355,128045,6244630,155977,88.7,97.3,66.9,93.4,90.9
2159,35840,"North Port-Sarasota-Bradenton, FL (Metropolitan Statistical Area)",2014,48666,169000,1555,170555,167445,36364450,747228,98.6,98,108.6,93.4,101
2160,35980,"Norwich-New London, CT (Metropolitan Statistical Area)",2014,51230,247700,2588,250288,245112,13906974,271462,101.7,98.1,110.7,100.7,104.1
2161,36100,"Ocala, FL (Metropolitan Statistical Area)",2014,32634,111500,2623,114123,108877,11030448,338005,90.6,98,75.8,93.4,92.8
2162,36140,"Ocean City, NJ (Metropolitan Statistical Area)",2014,51478,307000,7920,314920,299080,4885629,94907,106.4,101.2,112.1,107.6,109
2163,36220,"Odessa, TX (Metropolitan Statistical Area)",2014,47846,96800,3273,100073,93527,7396421,154588,96.3,98,98.4,93.4,98.7
2164,36260,"Ogden-Clearfield, UT (Metropolitan Statistical Area)",2014,37031,198200,1547,199747,196653,23358099,630767,95.6,95.8,85.6,101.5,97.9
2165,36420,"Oklahoma City, OK (Metropolitan Statistical Area)",2014,44924,133700,852,134552,132848,60029999,1336256,92.1,97.7,79.3,93.4,94.4
2166,36500,"Olympia-Lacey-Tumwater, WA (Metropolitan Statistical Area)",2014,44182,241300,2841,244141,238459,11704179,264909,106.7,106.4,113.2,103.8,109.4
2167,36540,"Omaha-Council Bluffs, NE-IA (Metropolitan Statistical Area)",2014,52044,145900,688,146588,145212,47013108,903335,93.6,97.2,86.3,93.3,95.9
2168,36740,"Orlando-Kissimmee-Sanford, FL (Metropolitan Statistical Area)",2014,37324,156100,977,157077,155123,86755807,2324391,97.7,98,104,93.4,100.1
2169,36780,"Oshkosh-Neenah, WI (Metropolitan Statistical Area)",2014,41579,142100,2180,144280,139920,7040261,169324,91.1,97.3,75.5,93.4,93.3
2170,36980,"Owensboro, KY (Metropolitan Statistical Area)",2014,38842,109100,2771,111871,106329,4526204,116529,87.6,97.3,62.4,93.4,89.8
2171,37100,"Oxnard-Thousand Oaks-Ventura, CA (Metropolitan Statistical Area)",2014,53064,444800,2527,447327,442273,44695387,842297,116.8,101.8,173.2,106.1,119.6
2172,37340,"Palm Bay-Melbourne-Titusville, FL (Metropolitan Statistical Area)",2014,39232,138500,2223,140723,136277,21795383,555548,95,98,92.2,93.4,97.3
2173,37460,"Panama City, FL (Metropolitan Statistical Area)",2014,38791,155000,2982,157982,152018,6916093,178289,94.7,97,92.5,93.6,97
2174,37620,"Parkersburg-Vienna, WV (Metropolitan Statistical Area)",2014,37631,103400,3117,106517,100283,3471769,92259,84.7,97.7,53.9,93.4,86.8
2175,37860,"Pensacola-Ferry Pass-Brent, FL (Metropolitan Statistical Area)",2014,38107,137200,2172,139372,135028,17934217,470628,93.4,98,85.7,93.4,95.6
2176,37900,"Peoria, IL (Metropolitan Statistical Area)",2014,43898,129900,1871,131771,128029,18238830,415479,91.2,97.2,74.7,93.3,93.5
2177,37980,"Philadelphia-Camden-Wilmington, PA-NJ-DE-MD (Metropolitan Statistical Area)",2014,55894,237600,788,238388,236812,337957214,6046382,106.1,101.2,112.2,107.6,108.7
2178,38060,"Phoenix-Mesa-Chandler, AZ (Metropolitan Statistical Area)",2014,39964,170200,711,170911,169489,179398666,4488970,97.1,97.4,97.2,96.6,99.5
2179,38220,"Pine Bluff, AR (Metropolitan Statistical Area)",2014,31257,79000,2819,81819,76181,2965681,94882,83.9,97,52.7,93.5,85.9
2180,38300,"Pittsburgh, PA (Metropolitan Statistical Area)",2014,49156,128100,765,128865,127335,115820957,2356189,94.4,98,78.4,98.3,96.7
2181,38340,"Pittsfield, MA (Metropolitan Statistical Area)",2014,48359,204100,4795,208895,199305,6231376,128856,96.3,98.1,86.7,100.7,98.6
2182,38540,"Pocatello, ID (Metropolitan Statistical Area)",2014,33003,143800,3254,147054,140546,3011992,91265,90.3,99.4,71.9,94.4,92.5
2183,38860,"Portland-South Portland, ME (Metropolitan Statistical Area)",2014,48410,232500,2022,234522,230478,25366411,523989,101.8,98.4,109.5,101.3,104.2
2184,38900,"Portland-Vancouver-Hillsboro, OR-WA (Metropolitan Statistical Area)",2014,47266,264200,1258,265458,262942,110791572,2343994,100.8,99.1,113,97.5,103.2
2185,38940,"Port St. Lucie, FL (Metropolitan Statistical Area)",2014,46614,140400,3103,143503,137297,20657591,443164,95.7,98,95.1,93.4,98
2186,39300,"Providence-Warwick, RI-MA (Metropolitan Statistical Area)",2014,47428,253900,1270,255170,252630,76408166,1611026,99.8,98.7,98.4,102,102.3
2187,39340,"Provo-Orem, UT (Metropolitan Statistical Area)",2014,33180,221100,1723,222823,219377,18947818,571059,97,95.5,92.1,101.9,99.4
2188,39380,"Pueblo, CO (Metropolitan Statistical Area)",2014,33970,137600,2622,140222,134978,5481218,161356,91.8,95.5,71.8,102,94
2189,39460,"Punta Gorda, FL (Metropolitan Statistical Area)",2014,36611,140900,4021,144921,136879,6152117,168041,94.7,98,91.2,93.4,97
2190,39540,"Racine, WI (Metropolitan Statistical Area)",2014,42596,167300,2097,169397,165203,8297153,194786,93.7,95.3,85.9,95.5,96
2191,39580,"Raleigh-Cary, NC (Metropolitan Statistical Area)",2014,47733,206600,1920,208520,204680,59246208,1241189,95.8,98,95.5,93.4,98.1
2192,39660,"Rapid City, SD (Metropolitan Statistical Area)",2014,44925,157300,2449,159749,154851,6030301,134231,92.1,96.3,82.8,92.7,94.3
2193,39740,"Reading, PA (Metropolitan Statistical Area)",2014,43091,169200,1606,170806,167594,17863904,414559,96.9,98.1,89.1,100.7,99.3
2194,39820,"Redding, CA (Metropolitan Statistical Area)",2014,39690,213700,4143,217843,209557,7098384,178844,97.8,95.5,96.2,102,100.2
2195,39900,"Reno, NV (Metropolitan Statistical Area)",2014,46204,200800,3049,203849,197751,20334744,440110,98.8,95.5,100.7,101.9,101.2
2196,40060,"Richmond, VA (Metropolitan Statistical Area) *",2014,49719,214900,1187,216087,213713,61403386,1235006,96,97.8,97.1,93.4,98.4
2197,40140,"Riverside-San Bernardino-Ontario, CA (Metropolitan Statistical Area)",2014,34628,231800,1262,233062,230538,152895111,4415343,107.5,101.8,118.8,106.1,110.1
2198,40220,"Roanoke, VA (Metropolitan Statistical Area) *",2014,41986,169400,1622,171022,167778,13130846,312747,90.9,97.1,77,93.5,93.2
2199,40340,"Rochester, MN (Metropolitan Statistical Area)",2014,47673,166600,1260,167860,165340,10138080,212659,93.5,96.2,88.3,92.6,95.7
2200,40380,"Rochester, NY (Metropolitan Statistical Area)",2014,44071,130900,856,131756,130044,47600486,1080094,98.5,98.1,95.5,100.7,100.9
2201,40420,"Rockford, IL (Metropolitan Statistical Area)",2014,38609,123500,1443,124943,122057,13220046,342409,90.8,97.3,74.9,93.4,93
2202,40580,"Rocky Mount, NC (Metropolitan Statistical Area)",2014,35344,100600,3252,103852,97348,5268555,149066,85.9,98,56.6,93.4,88
2203,40660,"Rome, GA (Metropolitan Statistical Area)",2014,34001,117500,4491,121991,113009,3259604,95868,80.8,91.2,58.8,93.5,82.7
2204,40900,"Sacramento-Roseville-Folsom, CA (Metropolitan Statistical Area)",2014,48293,275100,1248,276348,273852,107965573,2235640,102,95.5,118.5,102,104.5
2205,40980,"Saginaw, MI (Metropolitan Statistical Area)",2014,34167,94800,1710,96510,93090,6671107,195248,89,97.3,67.1,93.4,91.1
2206,41060,"St. Cloud, MN (Metropolitan Statistical Area)",2014,41787,164100,1294,165394,162806,8069353,193109,93,97.3,83.9,93.4,95.2
2207,41100,"St. George, UT (Metropolitan Statistical Area)",2014,31167,209500,5191,214691,204309,4708745,151081,94.7,99.4,88.4,94.4,97
2208,41140,"St. Joseph, MO-KS (Metropolitan Statistical Area)",2014,35529,110400,2407,112807,107993,4521406,127261,88.2,96.9,66.1,93,90.3
2209,41180,"St. Louis, MO-IL (Metropolitan Statistical Area)",2014,48023,156900,608,157508,156292,134629346,2803430,90.9,94.3,83.5,91.4,93.2
2210,41420,"Salem, OR (Metropolitan Statistical Area)",2014,36046,191100,2347,193447,188753,14493699,402092,94.8,99.1,82.2,97.5,97.1
2211,41500,"Salinas, CA (Metropolitan Statistical Area)",2014,48529,362100,6724,368824,355376,20793265,428475,107.7,95.5,153,102,110.3
2212,41540,"Salisbury, MD-DE (Metropolitan Statistical Area)",2014,42739,213600,3282,216882,210318,16615437,388766,89.7,91.2,84.1,93.5,91.9
2213,41620,"Salt Lake City, UT (Metropolitan Statistical Area)",2014,43016,227700,1319,229019,226381,49531185,1151447,99.3,95.6,103.9,101.7,101.8
2214,41660,"San Angelo, TX (Metropolitan Statistical Area)",2014,44566,102300,4113,106413,98187,5313686,119233,93.2,97.9,83.6,93.4,95.4
2215,41700,"San Antonio-New Braunfels, TX (Metropolitan Statistical Area)",2014,42559,134600,1053,135653,133547,99115825,2328894,94.3,97.7,89.4,93.4,96.6
2216,41740,"San Diego-Chula Vista-Carlsbad, CA (Metropolitan Statistical Area)",2014,52214,412800,2320,415120,410480,169638087,3248877,115.8,100.4,163.8,105.6,118.7
2217,41860,"San Francisco-Oakland-Berkeley, CA (Metropolitan Statistical Area)",2014,76355,592000,2430,594430,589570,350086443,4584981,123.7,110.9,183,111,126.7
2218,41940,"San Jose-Sunnyvale-Santa Clara, CA (Metropolitan Statistical Area)",2014,78001,654800,2948,657748,651852,152068950,1949578,125.7,110.6,200.5,110.8,128.7
2219,42020,"San Luis Obispo-Paso Robles, CA (Metropolitan Statistical Area)",2014,48690,426200,6653,432853,419547,13546769,278227,106.6,95.5,146.4,102,109.2
2220,42100,"Santa Cruz-Watsonville, CA (Metropolitan Statistical Area)",2014,56537,559500,7728,567228,551772,15313560,270861,124.2,110.9,173.8,111,127.2
2221,42140,"Santa Fe, NM (Metropolitan Statistical Area)",2014,50572,272700,5514,278214,267186,7473614,147782,99.4,95.5,104.4,102,101.9
2222,42200,"Santa Maria-Santa Barbara, CA (Metropolitan Statistical Area)",2014,53772,446500,11897,458397,434603,23608278,439045,108.7,95.5,166.2,102,111.4
2223,42220,"Santa Rosa-Petaluma, CA (Metropolitan Statistical Area)",2014,51550,414500,4921,419421,409579,25701006,498560,120.4,110.9,152.9,111,123.3
2224,42340,"Savannah, GA (Metropolitan Statistical Area)",2014,41455,168600,1707,170307,166893,15391089,371275,94.2,98,88.7,93.4,96.5
2225,42540,"Scranton--Wilkes-Barre, PA (Metropolitan Statistical Area)",2014,40000,132500,1432,133932,131068,22405645,560146,92.4,98.1,71.6,100.7,94.6
2226,42660,"Seattle-Tacoma-Bellevue, WA (Metropolitan Statistical Area)",2014,60831,315700,1481,317181,314219,223562420,3675160,109.3,106.4,129.3,103.8,112
2227,42680,"Sebastian-Vero Beach, FL (Metropolitan Statistical Area)",2014,66464,156300,3626,159926,152674,9600373,144445,90.9,91.2,87.8,93.5,93.1
2228,42700,"Sebring-Avon Park, FL (Metropolitan Statistical Area)",2014,30737,87700,2824,90524,84876,3030199,98584,84.8,91.2,71.8,93.5,86.8
2229,43100,"Sheboygan, WI (Metropolitan Statistical Area)",2014,45512,150800,2557,153357,148243,5233074,114982,91.2,97.3,74.8,93.4,93.4
2230,43300,"Sherman-Denison, TX (Metropolitan Statistical Area)",2014,37946,105800,3225,109025,102575,4690074,123599,90.9,98,74.5,93.4,93.1
2231,43340,"Shreveport-Bossier City, LA (Metropolitan Statistical Area)",2014,45366,122700,1907,124607,120793,18352090,404534,90.3,97.7,73.1,93.4,92.5
2232,43420,"Sierra Vista-Douglas, AZ (Metropolitan Statistical Area)",2014,35828,141300,4481,145781,136819,4561348,127314,91.3,99.4,76.5,94.4,93.5
2233,43580,"Sioux City, IA-NE-SD (Metropolitan Statistical Area)",2014,43141,108200,2230,110430,105970,6194640,143590,88.9,95.8,67.2,92.4,91.1
2234,43620,"Sioux Falls, SD (Metropolitan Statistical Area)",2014,51508,157600,1353,158953,156247,12677699,246133,92.3,97.2,80.5,93.3,94.6
2235,43780,"South Bend-Mishawaka, IN-MI (Metropolitan Statistical Area)",2014,40681,114700,1590,116290,113110,12993802,319410,89.7,96.8,72.4,93,91.9
2236,43900,"Spartanburg, SC (Metropolitan Statistical Area)",2014,38171,117700,2143,119843,115557,11183423,292981,87.6,97.6,64,93.4,89.7
2237,44060,"Spokane-Spokane Valley, WA (Metropolitan Statistical Area)",2014,39602,181100,1752,182852,179348,20843860,526336,95.4,96.1,84.8,100.8,97.7
2238,44100,"Springfield, IL (Metropolitan Statistical Area)",2014,43394,126900,2175,129075,124725,9186259,211692,91.6,97.3,74.5,93.4,93.8
2239,44140,"Springfield, MA (Metropolitan Statistical Area)",2014,45241,214000,1726,215726,212274,31744432,701671,97.7,98.1,92.6,100.7,100.1
2240,44180,"Springfield, MO (Metropolitan Statistical Area)",2014,36011,128100,1597,129697,126503,16260938,451556,88.1,97.1,66.9,93.2,90.2
2241,44220,"Springfield, OH (Metropolitan Statistical Area)",2014,36113,104200,2014,106214,102186,4922597,136311,87.8,97.3,63.3,93.4,90
2242,44300,"State College, PA (Metropolitan Statistical Area)",2014,41368,193500,5104,198604,188396,6604536,159653,103.4,98.1,119.6,100.7,106
2243,44420,"Staunton, VA (Metropolitan Statistical Area) *",2014,39554,185400,3930,189330,181470,4725516,119469,88.8,91.2,81.1,93.5,90.9
2244,44700,"Stockton, CA (Metropolitan Statistical Area)",2014,37651,211300,2772,214072,208528,26791397,711579,100,95.5,106.7,102,102.4
2245,44940,"Sumter, SC (Metropolitan Statistical Area)",2014,33118,108300,3680,111980,104620,4698720,141877,87.2,98,64.4,93.4,89.4
2246,45060,"Syracuse, NY (Metropolitan Statistical Area)",2014,42623,124400,874,125274,123526,28134800,660085,96.4,98.1,86.3,100.7,98.7
2247,45220,"Tallahassee, FL (Metropolitan Statistical Area)",2014,37058,164600,2131,166731,162469,13909855,375356,94.1,97.5,89.4,93.4,96.4
2248,45300,"Tampa-St. Petersburg-Clearwater, FL (Metropolitan Statistical Area)",2014,41445,141900,914,142814,140986,121324760,2927395,99.9,96.4,103.5,101.9,102.4
2249,45460,"Terre Haute, IN (Metropolitan Statistical Area)",2014,33701,87600,1272,88872,86328,6343808,188240,87.1,97,62.5,93.1,89.2
2250,45500,"Texarkana, TX-AR (Metropolitan Statistical Area)",2014,33908,94300,2455,96755,91845,5060072,149229,87.4,96.8,60.8,93.6,89.5
2251,45540,"The Villages, FL (Metropolitan Statistical Area)",2014,38618,199500,5357,204857,194143,4334341,112236,90.5,91.2,87.9,93.5,92.7
2252,45780,"Toledo, OH (Metropolitan Statistical Area)",2014,41140,115900,1198,117098,114702,26626809,647228,89.1,97.3,67.4,93.4,91.3
2253,45820,"Topeka, KS (Metropolitan Statistical Area)",2014,40690,118700,1596,120296,117104,9509957,233717,89.3,96.6,70.4,92.8,91.4
2254,45940,"Trenton-Princeton, NJ (Metropolitan Statistical Area)",2014,62033,280400,3655,284055,276745,22884552,368909,111.5,102.4,122.4,114.6,114.2
2255,46060,"Tucson, AZ (Metropolitan Statistical Area)",2014,38038,161700,1163,162863,160537,38198450,1004229,96.7,95.5,91.1,102,99.1
2256,46140,"Tulsa, OK (Metropolitan Statistical Area)",2014,59420,129100,979,130079,128121,57602524,969421,91,97.8,74.4,93.4,93.2
2257,46220,"Tuscaloosa, AL (Metropolitan Statistical Area)",2014,34572,143200,2677,145877,140523,8538838,246988,88.2,96.7,65.6,93.6,90.4
2258,46300,"Twin Falls, ID (Metropolitan Statistical Area)",2014,35968,148000,3636,151636,144364,3737470,103912,(NA),(NA),(NA),(NA),(NA)
2259,46340,"Tyler, TX (Metropolitan Statistical Area)",2014,51196,126400,3519,129919,122881,11244829,219642,93.7,98,86.2,93.4,96
2260,46520,"Urban Honolulu, HI (Metropolitan Statistical Area)",2014,50997,564400,4237,568637,560163,50354664,987414,124.5,113.4,177.9,107.9,127.6
2261,46540,"Utica-Rome, NY (Metropolitan Statistical Area)",2014,38267,107800,1346,109146,106454,11326380,295982,93.9,98.1,75.9,100.7,96.2
2262,46660,"Valdosta, GA (Metropolitan Statistical Area)",2014,31785,121800,3349,125149,118451,4559043,143433,82.5,91.2,64.6,93.5,84.5
2263,46700,"Vallejo, CA (Metropolitan Statistical Area)",2014,42593,263600,3263,266863,260337,18272859,429006,117.2,110.9,136.1,111,120.1
2264,47020,"Victoria, TX (Metropolitan Statistical Area)",2014,45799,115900,3340,119240,112560,4513360,98548,93.4,97.6,84.9,93.4,95.7
2265,47220,"Vineland-Bridgeton, NJ (Metropolitan Statistical Area)",2014,35526,165700,2472,168172,163228,5542374,156009,101,101.2,92,107.6,103.5
2266,47260,"Virginia Beach-Norfolk-Newport News, VA-NC (Metropolitan Statistical Area) *",2014,44793,235900,1029,236929,234871,78429675,1750937,98.3,97.9,106.9,93.4,100.7
2267,47300,"Visalia, CA (Metropolitan Statistical Area)",2014,36312,161000,2047,163047,158953,16527115,455138,95,95.5,83.5,102,97.3
2268,47380,"Waco, TX (Metropolitan Statistical Area)",2014,35555,108000,2445,110445,105555,9257603,260376,91.3,97.2,76.5,93.5,93.5
2269,47460,"Walla Walla, WA (Metropolitan Statistical Area)",2014,39556,189100,7017,196117,182083,2353961,59510,93.3,99.5,81.6,94.2,95.6
2270,47580,"Warner Robins, GA (Metropolitan Statistical Area)",2014,37471,128400,3277,131677,125123,6584218,175717,89.7,97.3,70.9,93.5,91.9
2271,47900,"Washington-Arlington-Alexandria, DC-VA-MD-WV (Metropolitan Statistical Area) *",2014,63278,373300,922,374222,372378,381692068,6031945,119.3,105.7,170.4,110.4,122.2
2272,47940,"Waterloo-Cedar Falls, IA (Metropolitan Statistical Area)",2014,41102,129300,2201,131501,127099,7005768,170450,90.9,96.5,76.7,92.8,93.1
2273,48060,"Watertown-Fort Drum, NY (Metropolitan Statistical Area)",2014,42846,135200,4452,139652,130748,5054577,117971,99.2,98.1,99,100.7,101.6
2274,48140,"Wausau-Weston, WI (Metropolitan Statistical Area)",2014,43132,142900,1890,144790,141010,7040917,163241,91.2,97.3,73.9,93.4,93.5
2275,48260,"Weirton-Steubenville, WV-OH (Metropolitan Statistical Area)",2014,35492,85300,1430,86730,83870,4312526,121507,86.1,97.3,55.8,93.4,88.2
2276,48300,"Wenatchee, WA (Metropolitan Statistical Area)",2014,41616,227900,5520,233420,222380,4739796,113894,95.6,99.4,91.2,94.4,98
2277,48540,"Wheeling, WV-OH (Metropolitan Statistical Area)",2014,39272,92600,2305,94905,90295,5693150,144968,85.6,98,54.8,93.4,87.7
2278,48620,"Wichita, KS (Metropolitan Statistical Area)",2014,48596,122800,1266,124066,121534,30752232,632810,90.3,97.1,72.1,93.3,92.5
2279,48660,"Wichita Falls, TX (Metropolitan Statistical Area)",2014,42496,89000,1572,90572,87428,6453771,151867,90.7,97.6,75,93.4,93
2280,48700,"Williamsport, PA (Metropolitan Statistical Area)",2014,39811,134600,2306,136906,132294,4629602,116290,94.1,98.1,78.8,100.7,96.4
2281,48900,"Wilmington, NC (Metropolitan Statistical Area)",2014,39043,199000,4070,203070,194930,10614264,271863,94.8,97.2,92.7,93.5,97.1
2282,49020,"Winchester, VA-WV (Metropolitan Statistical Area) *",2014,41075,204300,4284,208584,200016,5484592,133526,91.4,91.2,89.3,93.5,93.6
2283,49180,"Winston-Salem, NC (Metropolitan Statistical Area)",2014,39649,141900,1275,143175,140625,25900406,653250,89.6,98,69.4,93.4,91.8
2284,49340,"Worcester, MA-CT (Metropolitan Statistical Area)",2014,48152,247200,1586,248786,245614,44891417,932278,103.9,101,104.6,106.6,106.4
2285,49420,"Yakima, WA (Metropolitan Statistical Area)",2014,37960,157900,2298,160198,155602,9371247,246870,94.6,95.5,80.3,102,96.9
2286,49620,"York-Hanover, PA (Metropolitan Statistical Area)",2014,42928,170900,1362,172262,169538,18908619,440475,97.1,98.1,89.4,100.7,99.5
2287,49660,"Youngstown-Warren-Boardman, OH-PA (Metropolitan Statistical Area)",2014,37631,98600,852,99452,97748,20811376,553039,88.3,97.5,62.8,94.9,90.5
2288,49700,"Yuba City, CA (Metropolitan Statistical Area)",2014,37220,179100,4350,183450,174750,6264491,168311,98.2,95.5,97.7,102,100.6
2289,49740,"Yuma, AZ (Metropolitan Statistical Area) *",2014,29353,113500,2452,115952,111048,5989668,204054,92.9,95.5,76.2,102,95.2
2290,10180,"Abilene, TX (Metropolitan Statistical Area)",2013,39020,89000,2139,91139,86861,6534805,167473,90.9,96.8,75.7,94,91.8
2291,10420,"Akron, OH (Metropolitan Statistical Area)",2013,41800,139100,1221,140321,137879,29411698,703621,89.6,95.3,78.2,89.6,90.4
2292,10500,"Albany, GA (Metropolitan Statistical Area)",2013,33089,106300,2818,109118,103482,5051615,152667,84.4,96.7,55.8,94.1,85.2
2293,10540,"Albany-Lebanon, OR (Metropolitan Statistical Area)",2013,34009,173600,3291,176891,170309,4026793,118405,93.7,98.8,85.3,94.2,94.6
2294,10580,"Albany-Schenectady-Troy, NY (Metropolitan Statistical Area)",2013,48379,197500,1281,198781,196219,42431719,877065,99.6,98.1,104.4,98.8,100.6
2295,10740,"Albuquerque, NM (Metropolitan Statistical Area) *",2013,35354,179100,1683,180783,177417,31993265,904953,97.4,96.4,90.8,102.7,98.4
2296,10780,"Alexandria, LA (Metropolitan Statistical Area)",2013,38405,114300,3097,117397,111203,5938294,154623,87.9,97,64.7,94,88.8
2297,10900,"Allentown-Bethlehem-Easton, PA-NJ (Metropolitan Statistical Area)",2013,44750,207000,1657,208657,205343,36951573,825731,100.4,98.7,102,101.4,101.3
2298,11020,"Altoona, PA (Metropolitan Statistical Area)",2013,38099,106500,2434,108934,104066,4794185,125836,90.4,98.1,63.8,98.8,91.2
2299,11100,"Amarillo, TX (Metropolitan Statistical Area)",2013,40645,116800,1987,118787,114813,10522802,258896,93.1,97.3,83,94,93.9
2300,11180,"Ames, IA (Metropolitan Statistical Area)",2013,38615,162200,2957,165157,159243,4640000,120161,90.2,92.5,87.7,89.6,91.1
2301,11260,"Anchorage, AK (Metropolitan Statistical Area)",2013,54543,264300,2121,266421,262179,21654641,397022,108.4,102.3,144.2,100.7,109.4
2302,11460,"Ann Arbor, MI (Metropolitan Statistical Area)",2013,47645,198400,2730,201130,195670,16963525,356040,101.5,99,113.4,99.5,102.5
2303,11500,"Anniston-Oxford, AL (Metropolitan Statistical Area)",2013,32028,100600,3608,104208,96992,3730360,116471,85.1,97.5,54.2,94,85.9
2304,11540,"Appleton, WI (Metropolitan Statistical Area)",2013,42698,157800,1836,159636,155964,9819571,229978,93,97.8,80.6,93.6,93.9
2305,11700,"Asheville, NC (Metropolitan Statistical Area)",2013,36320,182100,2712,184812,179388,15828039,435795,92.6,95.7,85.7,94.1,93.5
2306,12020,"Athens-Clarke County, GA (Metropolitan Statistical Area)",2013,32446,163100,2240,165340,160860,6410966,197590,91.8,97.2,80,94,92.6
2307,12060,"Atlanta-Sandy Springs-Alpharetta, GA (Metropolitan Statistical Area)",2013,41810,170400,698,171098,169702,230395527,5510530,96,98.5,92.4,95.7,97
2308,12100,"Atlantic City-Hammonton, NJ (Metropolitan Statistical Area)",2013,42459,237400,2858,240258,234542,11647180,274314,106.7,102.2,111.8,107.8,107.7
2309,12220,"Auburn-Opelika, AL (Metropolitan Statistical Area)",2013,31909,146900,4872,151772,142028,4844011,151809,87,91.4,75,94,87.8
2310,12260,"Augusta-Richmond County, GA-SC (Metropolitan Statistical Area)",2013,34986,124700,1763,126463,122937,20285240,579802,89.7,97.1,70.9,94,90.6
2311,12420,"Austin-Round Rock-Georgetown, TX (Metropolitan Statistical Area)",2013,47233,192000,1286,193286,190714,88954305,1883315,98.6,97.5,110.7,94,99.6
2312,12540,"Bakersfield, CA (Metropolitan Statistical Area)",2013,35281,161700,1699,163399,160001,30412531,862000,98.1,96.4,94,102.7,99.1
2313,12580,"Baltimore-Columbia-Towson, MD (Metropolitan Statistical Area)",2013,52214,281400,1044,282444,280356,144540375,2768233,107.3,102.5,116.9,105.8,108.4
2314,12620,"Bangor, ME (Metropolitan Statistical Area)",2013,35182,137700,2729,140429,134971,5390675,153222,97.2,98.1,93.3,98.8,98.1
2315,12700,"Barnstable Town, MA (Metropolitan Statistical Area)",2013,59053,366700,3489,370189,363211,12667996,214518,102.1,98.1,116,98.8,103.1
2316,12940,"Baton Rouge, LA (Metropolitan Statistical Area)",2013,41628,158100,1354,159454,156746,35050425,841986,93,96.4,85,94.1,93.8
2317,12980,"Battle Creek, MI (Metropolitan Statistical Area)",2013,34137,98300,1788,100088,96512,4600038,134751,90.8,97.8,73.5,93.6,91.7
2318,13020,"Bay City, MI (Metropolitan Statistical Area)",2013,35287,93800,1869,95669,91931,3768444,106794,89.8,97.8,68.3,93.6,90.6
2319,13140,"Beaumont-Port Arthur, TX (Metropolitan Statistical Area)",2013,37467,95200,1430,96630,93770,14656804,391195,90.6,97.1,72,94.1,91.4
2320,13220,"Beckley, WV (Metropolitan Statistical Area)",2013,33515,84100,2046,86146,82054,4167737,124356,77.4,91.4,48.5,94,78.1
2321,13380,"Bellingham, WA (Metropolitan Statistical Area)",2013,40411,277000,4504,281504,272496,8327605,206073,100.4,96.4,105.2,102.8,101.3
2322,13460,"Bend, OR (Metropolitan Statistical Area)",2013,41171,249500,7711,257211,241789,6805466,165299,96.1,98.8,94.3,94.2,97
2323,13740,"Billings, MT (Metropolitan Statistical Area)",2013,44137,182000,2330,184330,179670,7651979,173367,97.4,96.5,90.4,102.3,98.3
2324,13780,"Binghamton, NY (Metropolitan Statistical Area)",2013,38245,108000,1736,109736,106264,9485515,248017,95.2,98.1,84.2,98.8,96.1
2325,13820,"Birmingham-Hoover, AL (Metropolitan Statistical Area)",2013,42461,143400,1415,144815,141985,45556037,1072882,89.8,97.2,70.3,94,90.7
2326,13900,"Bismarck, ND (Metropolitan Statistical Area)",2013,52366,164000,2122,166122,161878,6244114,119240,93.2,97.5,82.5,93.5,94.1
2327,13980,"Blacksburg-Christiansburg, VA (Metropolitan Statistical Area) *",2013,31722,158200,3225,161425,154975,5241762,165240,89,91.4,79,94.1,89.9
2328,14010,"Bloomington, IL (Metropolitan Statistical Area)",2013,43598,152800,2145,154945,150655,7631307,175037,93.7,97.1,86.4,93.2,94.6
2329,14020,"Bloomington, IN (Metropolitan Statistical Area)",2013,33424,147500,3413,150913,144087,5455509,163221,95.5,97.3,95.8,93.3,96.4
2330,14100,"Bloomsburg-Berwick, PA (Metropolitan Statistical Area)",2013,38424,139700,3206,142906,136494,3288807,85592,92.5,98.1,73.8,98.8,93.4
2331,14260,"Boise City, ID (Metropolitan Statistical Area)",2013,37596,166300,1441,167741,164859,24408039,649224,95.3,96.5,80.9,102.5,96.2
2332,14460,"Boston-Cambridge-Newton, MA-NH (Metropolitan Statistical Area)",2013,62416,362400,843,363243,361557,293535282,4702877,110.1,100.8,140,107.4,111.1
2333,14500,"Boulder, CO (Metropolitan Statistical Area) *",2013,56706,350900,4498,355398,346402,17540367,309323,109.6,101.5,141.4,100.7,110.6
2334,14540,"Bowling Green, KY (Metropolitan Statistical Area)",2013,31965,123700,2463,126163,121237,5263153,164653,85.9,91.4,65.1,94.2,86.7
2335,14740,"Bremerton-Silverdale-Port Orchard, WA (Metropolitan Statistical Area)",2013,45059,268200,3921,272121,264279,11372919,252401,105.9,106.7,112.6,102.1,106.9
2336,14860,"Bridgeport-Stamford-Norwalk, CT (Metropolitan Statistical Area)",2013,97235,432100,3744,435844,428356,91393072,939924,119.5,111.2,145.2,118.5,120.7
2337,15180,"Brownsville-Harlingen, TX (Metropolitan Statistical Area)",2013,25025,78300,1353,79653,76947,10444514,417357,85.3,97.5,58.6,94,86.1
2338,15260,"Brunswick, GA (Metropolitan Statistical Area)",2013,33627,134000,7277,141277,126723,3826129,113781,86,91.4,72.3,94,86.8
2339,15380,"Buffalo-Cheektowaga, NY (Metropolitan Statistical Area)",2013,42210,120700,819,121519,119881,47907088,1134974,94.2,98.1,79.1,98.8,95.1
2340,15500,"Burlington, NC (Metropolitan Statistical Area)",2013,34215,137000,3113,140113,133887,5274613,154162,90.2,97.5,72.2,94,91
2341,15540,"Burlington-South Burlington, VT (Metropolitan Statistical Area)",2013,49187,249900,2772,252672,247128,10566683,214827,102.6,98.1,120.2,98.8,103.6
2342,15680,"California-Lexington Park, MD (Metropolitan Statistical Area)",2013,49184,304700,7069,311769,297631,5372070,109224,98.8,91.4,117.8,94,99.8
2343,15940,"Canton-Massillon, OH (Metropolitan Statistical Area)",2013,38306,121500,1097,122597,120403,15451303,403365,89.1,97.8,65,93.6,89.9
2344,15980,"Cape Coral-Fort Myers, FL (Metropolitan Statistical Area)",2013,41309,149400,2691,152091,146709,27257232,659834,95.1,97.5,92.5,94,96
2345,16020,"Cape Girardeau, MO-IL (Metropolitan Statistical Area)",2013,36958,123000,2928,125928,120072,3591445,97177,84.4,92.5,68.4,89.6,85.2
2346,16060,"Carbondale-Marion, IL (Metropolitan Statistical Area)",2013,35388,96100,2807,98907,93293,4957077,140077,84.8,92.5,69.1,89.6,85.6
2347,16180,"Carson City, NV (Metropolitan Statistical Area)",2013,40782,198900,9524,208424,189376,2191065,53726,97.3,98.8,99.2,94.2,98.2
2348,16220,"Casper, WY (Metropolitan Statistical Area)",2013,62406,178300,3925,182225,174375,5061290,81103,98.5,96.4,95.7,102.7,99.5
2349,16300,"Cedar Rapids, IA (Metropolitan Statistical Area)",2013,45063,142100,1358,143458,140742,11838256,262706,91.1,97.1,74.6,93.1,91.9
2350,16540,"Chambersburg-Waynesboro, PA (Metropolitan Statistical Area)",2013,39102,177500,2674,180174,174826,5941372,151945,94.7,98.1,81.9,98.8,95.6
2351,16580,"Champaign-Urbana, IL (Metropolitan Statistical Area)",2013,42128,142400,2299,144699,140101,9388439,222854,93.9,97.2,88.2,93.2,94.7
2352,16620,"Charleston, WV (Metropolitan Statistical Area)",2013,38268,98400,2069,100469,96331,10539439,275412,88.9,97.1,64.8,94,89.8
2353,16700,"Charleston-North Charleston, SC (Metropolitan Statistical Area)",2013,40512,186900,2012,188912,184888,28814936,711272,96,97.5,96.3,94,96.9
2354,16740,"Charlotte-Concord-Gastonia, NC-SC (Metropolitan Statistical Area)",2013,42235,164800,838,165638,163962,99619040,2358660,93.4,97.1,84.9,94,94.3
2355,16820,"Charlottesville, VA (Metropolitan Statistical Area) *",2013,51339,262800,4436,267236,258364,10614551,206755,98.4,96.7,112.2,94.1,99.3
2356,16860,"Chattanooga, TN-GA (Metropolitan Statistical Area)",2013,38949,141300,1633,142933,139667,21117583,542181,90.4,97.3,72.9,94,91.3
2357,16940,"Cheyenne, WY (Metropolitan Statistical Area)",2013,48256,181700,3735,185435,177965,4618438,95707,97.9,96.4,92.5,102.7,98.8
2358,16980,"Chicago-Naperville-Elgin, IL-IN-WI (Metropolitan Statistical Area)",2013,49675,225000,557,225557,224443,474410590,9550194,104.5,101.8,116.7,101.8,105.5
2359,17020,"Chico, CA (Metropolitan Statistical Area)",2013,36407,225900,4437,230337,221463,8069386,221641,100.6,96.4,106.5,102.8,101.6
2360,17140,"Cincinnati, OH-KY-IN (Metropolitan Statistical Area)",2013,45052,153400,758,154158,152642,97406010,2162060,89.6,92.8,79.8,91.2,90.4
2361,17300,"Clarksville, TN-KY (Metropolitan Statistical Area)",2013,38078,132500,2415,134915,130085,10869085,285441,91.4,97.3,78.5,94,92.3
2362,17420,"Cleveland, TN (Metropolitan Statistical Area)",2013,34247,134800,4487,139287,130313,4055200,118410,84.3,91.4,66.4,94,85.1
2363,17460,"Cleveland-Elyria, OH (Metropolitan Statistical Area)",2013,44692,141900,784,142684,141116,92381865,2067100,89.9,95.3,80.1,89.6,90.8
2364,17660,"Coeur d'Alene, ID (Metropolitan Statistical Area)",2013,36451,188800,3710,192510,185090,5245180,143897,93.3,98.8,83.6,94.2,94.2
2365,17780,"College Station-Bryan, TX (Metropolitan Statistical Area)",2013,34023,140200,3217,143417,136983,8091327,237816,94.2,96.9,90,94,95.1
2366,17820,"Colorado Springs, CO (Metropolitan Statistical Area)",2013,41261,214200,1915,216115,212285,27998446,678565,99.8,96.5,102.6,102.5,100.7
2367,17860,"Columbia, MO (Metropolitan Statistical Area)",2013,40217,162200,2507,164707,159693,7996048,198824,92.6,97.8,80.6,93.6,93.5
2368,17900,"Columbia, SC (Metropolitan Statistical Area)",2013,37559,139400,1421,140821,137979,29703006,790842,92.2,97,80.6,94,93
2369,17980,"Columbus, GA-AL (Metropolitan Statistical Area)",2013,34157,132500,2973,135473,129527,11198267,327844,89.3,97.5,70.7,94,90.1
2370,18020,"Columbus, IN (Metropolitan Statistical Area)",2013,42443,134900,3530,138430,131370,3380775,79655,88.4,92.5,79.9,89.6,89.2
2371,18140,"Columbus, OH (Metropolitan Statistical Area)",2013,43900,158100,738,158838,157362,86661384,1974061,93.4,97.4,84.4,93.4,94.3
2372,18580,"Corpus Christi, TX (Metropolitan Statistical Area)",2013,41466,107700,1732,109432,105968,17377659,419080,93.1,97.3,83.9,94,93.9
2373,18700,"Corvallis, OR (Metropolitan Statistical Area)",2013,38497,270500,5015,275515,265485,3317145,86167,97.7,98.8,101.2,94.2,98.6
2374,18880,"Crestview-Fort Walton Beach-Destin, FL (Metropolitan Statistical Area)",2013,43101,177400,3416,180816,173984,10856216,251881,95.7,94.9,100.5,94.3,96.6
2375,19060,"Cumberland, MD-WV (Metropolitan Statistical Area)",2013,34277,119400,2658,122058,116742,3471108,101267,87.2,97.5,61.1,94,88
2376,19100,"Dallas-Fort Worth-Arlington, TX (Metropolitan Statistical Area)",2013,47092,150000,646,150646,149354,318057096,6753889,99.8,97.6,100.4,102,100.8
2377,19140,"Dalton, GA (Metropolitan Statistical Area)",2013,29074,114600,2999,117599,111601,4125797,141906,84.4,91.4,66.6,94,85.2
2378,19180,"Danville, IL (Metropolitan Statistical Area)",2013,35437,75300,2401,77701,72899,2855701,80585,80.2,92.5,55.3,89.6,81
2379,19300,"Daphne-Fairhope-Foley, AL (Metropolitan Statistical Area)",2013,38222,168600,2572,171172,166028,7448839,194885,92.4,97.5,83.4,94,93.3
2380,19340,"Davenport-Moline-Rock Island, IA-IL (Metropolitan Statistical Area)",2013,43820,124600,1305,125905,123295,16819940,383843,91.5,97.6,75.1,93.5,92.3
2381,19460,"Decatur, AL (Metropolitan Statistical Area)",2013,33629,114300,2719,117019,111581,5150165,153146,86.6,97.5,56.1,94,87.4
2382,19500,"Decatur, IL (Metropolitan Statistical Area)",2013,42962,93300,1978,95278,91322,4707012,109561,90,97.8,67.7,93.6,90.8
2383,19660,"Deltona-Daytona Beach-Ormond Beach, FL (Metropolitan Statistical Area)",2013,35454,148500,1627,150127,146873,21280911,600236,95.5,97.5,94.2,94,96.4
2384,19740,"Denver-Aurora-Lakewood, CO (Metropolitan Statistical Area) *",2013,51785,247800,890,248690,246910,139847697,2700529,104.4,101.5,115.3,100.6,105.4
2385,19780,"Des Moines-West Des Moines, IA (Metropolitan Statistical Area)",2013,45634,156400,1267,157667,155133,29107336,637846,94.8,97.6,90.6,93.5,95.7
2386,19820,"Detroit-Warren-Dearborn, MI (Metropolitan Statistical Area)",2013,42754,124400,529,124929,123871,184082752,4305587,97.1,99,87.9,99.5,98
2387,20020,"Dothan, AL (Metropolitan Statistical Area)",2013,35551,107400,2862,110262,104538,5241972,147449,85.2,96.3,56.9,94.1,86
2388,20100,"Dover, DE (Metropolitan Statistical Area)",2013,36278,199500,3223,202723,196277,6132355,169038,93.7,97.5,86.9,94,94.6
2389,20220,"Dubuque, IA (Metropolitan Statistical Area)",2013,41156,145900,2287,148187,143613,3948700,95945,92.6,97.8,80.8,93.6,93.5
2390,20260,"Duluth, MN-WI (Metropolitan Statistical Area)",2013,39498,140000,1658,141658,138342,11462135,290193,91.4,97.3,78.2,93.3,92.3
2391,20500,"Durham-Chapel Hill, NC (Metropolitan Statistical Area)",2013,43569,193100,2689,195789,190411,25721515,590364,95.2,97.3,92.7,94,96.1
2392,20700,"East Stroudsburg, PA (Metropolitan Statistical Area)",2013,35124,191800,3054,194854,188746,5878132,167355,99.1,98.1,101.5,98.8,100.1
2393,20740,"Eau Claire, WI (Metropolitan Statistical Area)",2013,40502,149200,2080,151280,147120,6675634,164822,92.1,97.8,78,93.6,93
2394,20940,"El Centro, CA (Metropolitan Statistical Area)",2013,33401,147300,4878,152178,142422,5893251,176438,91.1,98.8,76.4,94.2,92
2395,21060,"Elizabethtown-Fort Knox, KY (Metropolitan Statistical Area)",2013,35410,133600,3781,137381,129819,5390343,152228,87,91.4,75.4,94,87.9
2396,21140,"Elkhart-Goshen, IN (Metropolitan Statistical Area)",2013,35784,121700,2271,123971,119429,7164192,200205,91,97.8,74.2,93.6,91.9
2397,21300,"Elmira, NY (Metropolitan Statistical Area)",2013,38155,94300,1854,96154,92446,3365193,88199,94.6,98.1,81.4,98.8,95.5
2398,21340,"El Paso, TX (Metropolitan Statistical Area)",2013,30264,111400,1033,112433,110367,25246542,834203,90.7,97.5,76.4,94,91.6
2399,21420,"Enid, OK (Metropolitan Statistical Area)",2013,42512,89400,3466,92866,85934,2651459,62370,87.5,97.5,61.3,94,88.3
2400,21500,"Erie, PA (Metropolitan Statistical Area)",2013,37975,115100,1714,116814,113386,10660159,280717,93.1,98.1,75.6,98.8,94
2401,21660,"Eugene-Springfield, OR (Metropolitan Statistical Area)",2013,36489,218900,1943,220843,216957,12971081,355481,98.8,96.4,97.6,102.8,99.8
2402,21780,"Evansville, IN-KY (Metropolitan Statistical Area)",2013,40392,120300,2005,122305,118295,12696524,314331,91,97.8,72.3,93.6,91.9
2403,21820,"Fairbanks, AK (Metropolitan Statistical Area) *",2013,49150,212500,5365,217865,207135,4960891,100933,106.9,98.8,157.7,94.2,107.9
2404,22020,"Fargo, ND-MN (Metropolitan Statistical Area)",2013,47009,157600,2165,159765,155435,10499977,223360,93.4,97.8,83.6,93.6,94.3
2405,22140,"Farmington, NM (Metropolitan Statistical Area)",2013,32159,148700,5766,154466,142934,4163504,129467,91.2,98.8,73.4,94.2,92.1
2406,22180,"Fayetteville, NC (Metropolitan Statistical Area)",2013,32765,130200,2544,132744,127656,16683199,509180,91.3,97,79.2,94,92.2
2407,22220,"Fayetteville-Springdale-Rogers, AR (Metropolitan Statistical Area)",2013,48755,143400,1723,145123,141677,22970415,471140,90.6,97.3,72.7,93.9,91.5
2408,22380,"Flagstaff, AZ (Metropolitan Statistical Area)",2013,38345,220400,7219,227619,213181,5241669,136699,98.5,98.8,105.5,94.2,99.5
2409,22420,"Flint, MI (Metropolitan Statistical Area)",2013,33913,91700,1351,93051,90349,14095656,415639,93.1,99,69.9,99.5,94
2410,22500,"Florence, SC (Metropolitan Statistical Area)",2013,33928,104700,2886,107586,101814,6988775,205986,86.3,96.2,60.2,94.1,87.1
2411,22520,"Florence-Muscle Shoals, AL (Metropolitan Statistical Area)",2013,32951,109200,2487,111687,106713,4851395,147230,83.7,97.5,48.8,94,84.5
2412,22540,"Fond du Lac, WI (Metropolitan Statistical Area)",2013,40067,145800,2279,148079,143521,4078347,101787,87.5,92.5,76.8,89.6,88.3
2413,22660,"Fort Collins, CO (Metropolitan Statistical Area)",2013,42550,247100,2750,249850,244350,13455320,316225,101.6,96.4,113,102.8,102.6
2414,22900,"Fort Smith, AR-OK (Metropolitan Statistical Area)",2013,33043,100100,1995,102095,98105,8213436,248569,85.8,96.9,57.8,94,86.6
2415,23060,"Fort Wayne, IN (Metropolitan Statistical Area)",2013,38334,113800,1081,114881,112719,15204623,396638,90.6,97.8,70.2,93.6,91.4
2416,23420,"Fresno, CA (Metropolitan Statistical Area)",2013,35591,195400,2457,197857,192943,33865015,951514,98.1,96.4,94,102.8,99
2417,23460,"Gadsden, AL (Metropolitan Statistical Area)",2013,31629,100000,3012,103012,96988,3285699,103884,83.7,97.5,50.7,94,84.5
2418,23540,"Gainesville, FL (Metropolitan Statistical Area)",2013,35504,163300,2562,165862,160738,10965953,308865,95.6,97.3,95,94,96.5
2419,23580,"Gainesville, GA (Metropolitan Statistical Area)",2013,34277,165300,2390,167690,162910,6390361,186431,90.5,91.4,85.6,94,91.4
2420,23900,"Gettysburg, PA (Metropolitan Statistical Area)",2013,40852,198200,3086,201286,195114,4131688,101137,96.3,98.1,88.7,98.8,97.3
2421,24020,"Glens Falls, NY (Metropolitan Statistical Area)",2013,39330,166600,2246,168846,164354,5028250,127848,97.6,98.1,94.5,98.8,98.5
2422,24140,"Goldsboro, NC (Metropolitan Statistical Area)",2013,33663,108600,3197,111797,105403,4193916,124587,87.5,97.5,62.5,94,88.3
2423,24220,"Grand Forks, ND-MN (Metropolitan Statistical Area)",2013,44426,144100,2533,146633,141567,4475505,100741,92.9,97.8,81.7,93.6,93.7
2424,24260,"Grand Island, NE (Metropolitan Statistical Area)",2013,39108,109200,2472,111672,106728,2919504,74652,85.5,92.5,65.9,89.7,86.3
2425,24300,"Grand Junction, CO (Metropolitan Statistical Area)",2013,37745,210100,4033,214133,206067,5555135,147175,94.9,98.8,89.8,94.2,95.8
2426,24340,"Grand Rapids-Kentwood, MI (Metropolitan Statistical Area)",2013,41478,139300,977,140277,138323,42535063,1025473,93.3,97.2,84.6,93.2,94.1
2427,24420,"Grants Pass, OR (Metropolitan Statistical Area)",2013,32659,220900,7334,228234,213566,2714952,83131,93.9,98.8,86.5,94.2,94.8
2428,24500,"Great Falls, MT (Metropolitan Statistical Area)",2013,39928,157900,2325,160225,155575,3281825,82194,94.4,96.4,77.2,102.7,95.3
2429,24540,"Greeley, CO (Metropolitan Statistical Area) *",2013,38793,191500,3040,194540,188460,10480583,270165,97.6,101.5,88.5,100.7,98.5
2430,24580,"Green Bay, WI (Metropolitan Statistical Area)",2013,43870,156800,1274,158074,155526,13685094,311947,92,97.1,79.1,93.1,92.9
2431,24660,"Greensboro-High Point, NC (Metropolitan Statistical Area)",2013,36774,140600,1276,141876,139324,27234702,740604,90.2,97.1,72.3,94,91
2432,24780,"Greenville, NC (Metropolitan Statistical Area)",2013,35409,134900,3438,138338,131462,6174600,174380,88.7,97.5,67.3,94,89.5
2433,24860,"Greenville-Anderson, SC (Metropolitan Statistical Area)",2013,36434,137300,1695,138995,135605,30911264,848417,90.2,97.3,72.4,94,91.1
2434,25060,"Gulfport-Biloxi, MS (Metropolitan Statistical Area)",2013,33971,134400,2391,136791,132009,13586270,399940,90.5,97.5,75.2,94,91.4
2435,25180,"Hagerstown-Martinsburg, MD-WV (Metropolitan Statistical Area)",2013,37664,185500,3400,188900,182100,10354873,274926,102.4,105.9,87.7,109.8,103.4
2436,25220,"Hammond, LA (Metropolitan Statistical Area)",2013,34418,135400,5699,141099,129701,4320092,125520,85.8,91.4,70.8,94,86.7
2437,25260,"Hanford-Corcoran, CA (Metropolitan Statistical Area)",2013,30313,176900,4534,181434,172366,4557239,150337,94.2,98.8,87,94.2,95.1
2438,25420,"Harrisburg-Carlisle, PA (Metropolitan Statistical Area)",2013,44207,169200,1127,170327,168073,24673697,558139,96.8,98.1,90.4,98.8,97.7
2439,25500,"Harrisonburg, VA (Metropolitan Statistical Area) *",2013,33783,198200,4769,202969,193431,4356463,128956,92.7,91.4,93,94,93.6
2440,25540,"Hartford-East Hartford-Middletown, CT (Metropolitan Statistical Area)",2013,54840,249900,1369,251269,248531,66618872,1214785,100.9,98.3,110.2,99.2,101.9
2441,25620,"Hattiesburg, MS (Metropolitan Statistical Area)",2013,33571,132700,4717,137417,127983,5605426,166971,85,91.4,69.3,94,85.9
2442,25860,"Hickory-Lenoir-Morganton, NC (Metropolitan Statistical Area)",2013,32257,120100,1746,121846,118354,11721409,363379,89,97.5,66.4,94,89.9
2443,25940,"Hilton Head Island-Bluffton, SC (Metropolitan Statistical Area)",2013,42432,250200,7863,258063,242337,8371551,197292,94.4,91.4,98.9,94,95.3
2444,25980,"Hinesville, GA (Metropolitan Statistical Area)",2013,30251,124400,5597,129997,118803,2384508,78825,91.6,91.4,89.6,94,92.4
2445,26140,"Homosassa Springs, FL (Metropolitan Statistical Area)",2013,33128,117400,3219,120619,114181,4599114,138829,89.6,91.4,83.6,94,90.5
2446,26300,"Hot Springs, AR (Metropolitan Statistical Area)",2013,33825,130500,4808,135308,125692,3303183,97654,85.7,91.4,70.6,94,86.5
2447,26380,"Houma-Thibodaux, LA (Metropolitan Statistical Area)",2013,42693,129400,3367,132767,126033,8964822,209983,92.6,97.5,80.4,94,93.5
2448,26420,"Houston-The Woodlands-Sugar Land, TX (Metropolitan Statistical Area)",2013,51525,141400,542,141942,140858,326058563,6328208,100.5,96.3,99.1,106.1,101.4
2449,26580,"Huntington-Ashland, WV-KY-OH (Metropolitan Statistical Area)",2013,33933,100400,1969,102369,98431,12561158,370179,87.2,97.4,58.9,94,88
2450,26620,"Huntsville, AL (Metropolitan Statistical Area)",2013,42424,158500,1713,160213,156787,18477485,435541,91.1,97.5,72.9,94,92
2451,26820,"Idaho Falls, ID (Metropolitan Statistical Area)",2013,36051,154200,2472,156672,151728,4933275,136840,90.7,98.8,72.5,94.2,91.6
2452,26900,"Indianapolis-Carmel-Anderson, IN (Metropolitan Statistical Area)",2013,45756,140200,762,140962,139438,89388762,1953600,93.5,97.7,84.4,93.5,94.3
2453,26980,"Iowa City, IA (Metropolitan Statistical Area)",2013,45325,175000,3449,178449,171551,7347004,162095,95.9,97.3,97.9,93.2,96.8
2454,27060,"Ithaca, NY (Metropolitan Statistical Area)",2013,37960,169200,3314,172514,165886,3930838,103553,104.4,98.1,129.6,98.8,105.4
2455,27100,"Jackson, MI (Metropolitan Statistical Area)",2013,32777,112800,2044,114844,110756,5232184,159628,91.3,97.8,75,93.6,92.2
2456,27140,"Jackson, MS (Metropolitan Statistical Area)",2013,39555,127500,2159,129659,125341,23587358,596325,90.7,97.1,74.1,94,91.5
2457,27180,"Jackson, TN (Metropolitan Statistical Area)",2013,35471,107600,2425,110025,105175,6378938,179836,83.3,91.4,60.5,94.1,84.1
2458,27260,"Jacksonville, FL (Metropolitan Statistical Area)",2013,41605,163600,1303,164903,162297,57973424,1393432,96,97.5,96.7,94,96.9
2459,27340,"Jacksonville, NC (Metropolitan Statistical Area)",2013,41905,151700,3580,155280,148120,8060613,192354,95,97.5,92.5,94,95.9
2460,27500,"Janesville-Beloit, WI (Metropolitan Statistical Area)",2013,38350,133000,1711,134711,131289,6149006,160341,92.3,97.8,79.1,93.6,93.2
2461,27620,"Jefferson City, MO (Metropolitan Statistical Area)",2013,37600,133700,2979,136679,130721,5665152,150669,82.7,92.5,60.3,89.6,83.5
2462,27740,"Johnson City, TN (Metropolitan Statistical Area)",2013,34594,128200,2740,130940,125460,6935132,200470,88,97.5,63.7,94,88.8
2463,27780,"Johnstown, PA (Metropolitan Statistical Area)",2013,36740,87100,1677,88777,85423,5100404,138826,86.2,98.1,51.2,98.8,87
2464,27860,"Jonesboro, AR (Metropolitan Statistical Area)",2013,33211,105700,3755,109455,101945,4179220,125840,82.3,91.4,61.4,94,83
2465,27900,"Joplin, MO (Metropolitan Statistical Area)",2013,33930,101300,2311,103611,98989,5942607,175144,87.9,97.8,61.4,93.6,88.7
2466,27980,"Kahului-Wailuku-Lahaina, HI (Metropolitan Statistical Area)",2013,39225,523700,13013,536713,510687,6318893,161093,107.5,98.8,148.7,94.2,108.5
2467,28020,"Kalamazoo-Portage, MI (Metropolitan Statistical Area)",2013,40358,132600,1951,134551,130649,10384592,257311,92.3,97.8,79,93.6,93.1
2468,28100,"Kankakee, IL (Metropolitan Statistical Area)",2013,35600,145900,3212,149112,142688,4013319,112735,97.6,101.9,83,101.8,98.5
2469,28140,"Kansas City, MO-KS (Metropolitan Statistical Area)",2013,46147,158300,642,158942,157658,94778441,2053850,94.3,96.7,84.6,96,95.1
2470,28420,"Kennewick-Richland, WA (Metropolitan Statistical Area)",2013,37979,171500,1907,173407,169593,10283417,270766,98.4,96.4,95.1,102.7,99.3
2471,28660,"Killeen-Temple, TX (Metropolitan Statistical Area)",2013,37546,119200,1586,120786,117614,15917085,423931,92.7,97.3,83.2,94,93.6
2472,28700,"Kingsport-Bristol, TN-VA (Metropolitan Statistical Area) *",2013,35722,117400,1868,119268,115532,10995712,307811,86.5,97.5,58.6,94,87.4
2473,28740,"Kingston, NY (Metropolitan Statistical Area)",2013,41308,232400,2651,235051,229749,7464233,180698,103.3,98.1,123.9,98.8,104.3
2474,28940,"Knoxville, TN (Metropolitan Statistical Area)",2013,38416,147000,1530,148530,145470,31847141,829017,90.8,96.8,74.3,94.1,91.6
2475,29020,"Kokomo, IN (Metropolitan Statistical Area)",2013,35192,98500,2169,100669,96331,2911701,82738,87.9,97.8,62.4,93.6,88.7
2476,29100,"La Crosse-Onalaska, WI-MN (Metropolitan Statistical Area)",2013,41688,155000,1862,156862,153138,5655213,135655,92.9,97.8,82,93.6,93.8
2477,29180,"Lafayette, LA (Metropolitan Statistical Area)",2013,43983,127500,2316,129816,125184,21102581,479794,89,96.4,67.8,94.1,89.8
2478,29200,"Lafayette-West Lafayette, IN (Metropolitan Statistical Area)",2013,34411,123500,1881,125381,121619,7542326,219183,94.3,97.2,90.4,93.2,95.2
2479,29340,"Lake Charles, LA (Metropolitan Statistical Area)",2013,38565,118100,3066,121166,115034,7798002,202205,89,97.4,66.8,94,89.9
2480,29420,"Lake Havasu City-Kingman, AZ (Metropolitan Statistical Area)",2013,26810,133900,3281,137181,130619,5445864,203126,94.6,96.4,79.2,102.7,95.5
2481,29460,"Lakeland-Winter Haven, FL (Metropolitan Statistical Area)",2013,31555,111400,1751,113151,109649,19647197,622633,93.6,97.5,86.4,94,94.5
2482,29540,"Lancaster, PA (Metropolitan Statistical Area)",2013,41981,188200,1509,189709,186691,22250179,530012,99,98.1,101.3,98.8,99.9
2483,29620,"Lansing-East Lansing, MI (Metropolitan Statistical Area)",2013,34706,132900,1520,134420,131380,18674851,538089,93.9,97.8,86.3,93.6,94.8
2484,29700,"Laredo, TX (Metropolitan Statistical Area)",2013,28496,108800,1894,110694,106906,7535089,264430,88.9,97.5,70,94,89.8
2485,29740,"Las Cruces, NM (Metropolitan Statistical Area)",2013,30423,139100,2920,142020,136180,6519376,214288,92.9,96.4,72.8,102.7,93.8
2486,29820,"Las Vegas-Henderson-Paradise, NV (Metropolitan Statistical Area)",2013,38316,165000,1139,166139,163861,77290997,2017193,99.9,96.4,102.6,102.8,100.8
2487,29940,"Lawrence, KS (Metropolitan Statistical Area)",2013,36557,180300,3553,183853,176747,4193525,114713,95.1,97.8,92.4,93.6,96
2488,30020,"Lawton, OK (Metropolitan Statistical Area)",2013,37176,109500,3312,112812,106188,4874270,131113,91.2,96.9,75.9,94.1,92.1
2489,30140,"Lebanon, PA (Metropolitan Statistical Area)",2013,39585,164300,1909,166209,162391,5375756,135804,94.8,98.1,82.4,98.8,95.7
2490,30300,"Lewiston, ID-WA (Metropolitan Statistical Area)",2013,37849,168000,3518,171518,164482,2343867,61927,90.5,98.8,72.1,94.2,91.4
2491,30340,"Lewiston-Auburn, ME (Metropolitan Statistical Area)",2013,35456,154800,2340,157140,152460,3801661,107223,95.6,98.1,86.1,98.8,96.5
2492,30460,"Lexington-Fayette, KY (Metropolitan Statistical Area)",2013,41078,162300,1338,163638,160962,20165627,490906,92.3,97.5,78.9,94,93.2
2493,30620,"Lima, OH (Metropolitan Statistical Area)",2013,35522,105000,2466,107466,102534,3731759,105055,88.9,97.8,64.6,93.6,89.7
2494,30700,"Lincoln, NE (Metropolitan Statistical Area)",2013,42005,148300,1508,149808,146792,13193908,314103,92.7,97.6,81.2,93.5,93.6
2495,30780,"Little Rock-North Little Rock-Conway, AR (Metropolitan Statistical Area)",2013,39633,135000,1350,136350,133650,28661039,723159,90.9,97.4,74.1,94,91.8
2496,30860,"Logan, UT-ID (Metropolitan Statistical Area)",2013,30952,185000,2885,187885,182115,4018403,129827,90.3,98.8,71.7,94.2,91.2
2497,30980,"Longview, TX (Metropolitan Statistical Area)",2013,39999,108000,2149,110149,105851,11303292,282589,92.2,96.5,80.8,94.1,93
2498,31020,"Longview, WA (Metropolitan Statistical Area)",2013,38331,181500,4861,186361,176639,3889914,101483,93.3,98.8,83.5,94.2,94.2
2499,31080,"Los Angeles-Long Beach-Anaheim, CA (Metropolitan Statistical Area)",2013,50487,448000,1190,449190,446810,661248242,13097434,117.8,104.8,166.3,107,118.9
2500,31140,"Louisville/Jefferson County, KY-IN (Metropolitan Statistical Area)",2013,41391,147100,700,147800,146400,51001056,1232178,91.1,97.2,74.8,94,92
2501,31180,"Lubbock, TX (Metropolitan Statistical Area)",2013,37264,106800,1712,108512,105088,11222817,301167,93.4,97.2,85.1,94,94.3
2502,31340,"Lynchburg, VA (Metropolitan Statistical Area) *",2013,35198,160200,1954,162154,158246,9040045,256832,90.6,97.3,73.4,94,91.4
2503,31420,"Macon-Bibb County, GA (Metropolitan Statistical Area)",2013,34625,122100,2930,125030,119170,8006073,231225,87.9,96.8,64.8,94.1,88.7
2504,31460,"Madera, CA (Metropolitan Statistical Area)",2013,32872,182000,6982,188982,175018,4975765,151370,97.2,96.4,90.2,102.8,98.2
2505,31540,"Madison, WI (Metropolitan Statistical Area)",2013,48950,217500,1277,218777,216223,30683543,626833,97.5,97.2,107.4,93.1,98.4
2506,31700,"Manchester-Nashua, NH (Metropolitan Statistical Area)",2013,51707,249900,2075,251975,247825,20955970,405281,107.5,100.6,124.2,106.8,108.5
2507,31740,"Manhattan, KS (Metropolitan Statistical Area)",2013,40138,163700,3396,167096,160304,5470577,136294,94.1,92.5,102.5,89.6,95
2508,31860,"Mankato, MN (Metropolitan Statistical Area)",2013,40447,163100,2214,165314,160886,3952445,97718,88.6,92.5,81.9,89.6,89.4
2509,31900,"Mansfield, OH (Metropolitan Statistical Area)",2013,33568,103500,2245,105745,101255,4105807,122314,87.4,97.8,60.2,93.6,88.3
2510,32580,"McAllen-Edinburg-Mission, TX (Metropolitan Statistical Area)",2013,23639,78100,1493,79593,76607,19350997,818619,85.1,97.5,57.2,94,85.9
2511,32780,"Medford, OR (Metropolitan Statistical Area)",2013,36501,225100,4025,229125,221075,7562155,207179,98.7,96.4,97.1,102.8,99.7
2512,32820,"Memphis, TN-MS-AR (Metropolitan Statistical Area)",2013,40233,134300,1335,135635,132965,53594324,1332114,92.1,97.3,79.3,94,93
2513,32900,"Merced, CA (Metropolitan Statistical Area)",2013,32369,146400,3710,150110,142690,8481612,262026,96.2,96.4,85.6,102.7,97.1
2514,33100,"Miami-Fort Lauderdale-Pompano Beach, FL (Metropolitan Statistical Area)",2013,45087,194300,1030,195330,193270,262528810,5822754,105.8,100.3,128.9,99.3,106.9
2515,33140,"Michigan City-La Porte, IN (Metropolitan Statistical Area)",2013,36208,122800,2493,125293,120307,4034373,111423,86,92.5,72.3,89.6,86.8
2516,33220,"Midland, MI (Metropolitan Statistical Area)",2013,44311,128600,3231,131831,125369,3706693,83651,91.6,97.8,75.8,93.6,92.5
2517,33260,"Midland, TX (Metropolitan Statistical Area)",2013,110176,145700,4963,150663,140737,17366897,157628,98.4,97.2,113.3,94.1,99.3
2518,33340,"Milwaukee-Waukesha, WI (Metropolitan Statistical Area)",2013,47777,198100,802,198902,197298,75092081,1571732,95.7,95.8,97.1,95,96.6
2519,33460,"Minneapolis-St. Paul-Bloomington, MN-WI (Metropolitan Statistical Area)",2013,51645,216500,769,217269,215731,177698320,3440782,102.4,104.1,109.8,97.1,103.3
2520,33540,"Missoula, MT (Metropolitan Statistical Area)",2013,38438,237500,5737,243237,231763,4301255,111900,96.5,98.8,96,94.2,97.4
2521,33660,"Mobile, AL (Metropolitan Statistical Area)",2013,33850,124300,1929,126229,122371,14583275,430815,88.1,97.5,65.3,94,88.9
2522,33700,"Modesto, CA (Metropolitan Statistical Area)",2013,35381,172900,1848,174748,171052,18520025,523451,99.6,96.4,101.4,102.8,100.5
2523,33740,"Monroe, LA (Metropolitan Statistical Area)",2013,35384,111500,3495,114995,108005,7269846,205454,86.6,97.1,59.2,94,87.5
2524,33780,"Monroe, MI (Metropolitan Statistical Area)",2013,38049,139100,2496,141596,136604,5712695,150139,95.3,99,79.5,99.5,96.2
2525,33860,"Montgomery, AL (Metropolitan Statistical Area)",2013,37009,128100,2242,130342,125858,13845430,374114,89.5,97.5,69.8,94,90.3
2526,34060,"Morgantown, WV (Metropolitan Statistical Area)",2013,36210,143100,4876,147976,138224,4922613,135948,88.4,91.4,78.6,94,89.3
2527,34100,"Morristown, TN (Metropolitan Statistical Area)",2013,30850,123800,2808,126608,120992,4254914,137924,83,91.4,64,94,83.7
2528,34580,"Mount Vernon-Anacortes, WA (Metropolitan Statistical Area)",2013,42576,261400,5043,266443,256357,5034845,118255,98.4,98.8,104.4,94.2,99.3
2529,34620,"Muncie, IN (Metropolitan Statistical Area)",2013,31392,89600,1552,91152,88048,3667609,116831,90.1,97.8,72.1,93.6,90.9
2530,34740,"Muskegon, MI (Metropolitan Statistical Area)",2013,31731,100900,1923,102823,98977,5466398,172273,89,97.8,66.5,93.6,89.9
2531,34820,"Myrtle Beach-Conway-North Myrtle Beach, SC-NC (Metropolitan Statistical Area)",2013,32326,166000,1851,167851,164149,13050332,403705,92.4,96.1,86.8,94.1,93.3
2532,34900,"Napa, CA (Metropolitan Statistical Area)",2013,55523,428600,10044,438644,418556,7749903,139580,119.5,109.4,158,109.3,120.6
2533,34940,"Naples-Marco Island, FL (Metropolitan Statistical Area)",2013,69392,261300,5318,266618,255982,23522984,338987,98.9,97.5,113.7,94,99.9
2534,34980,"Nashville-Davidson--Murfreesboro--Franklin, TN (Metropolitan Statistical Area)",2013,46603,171800,887,172687,170913,80856009,1735012,93.7,97.2,86.6,94,94.6
2535,35100,"New Bern, NC (Metropolitan Statistical Area)",2013,37803,148400,4705,153105,143695,4807477,127172,87.8,91.4,78.3,94,88.7
2536,35300,"New Haven-Milford, CT (Metropolitan Statistical Area)",2013,48597,256900,1851,258751,255049,41930035,862820,112.7,108.2,117.1,114.8,113.7
2537,35380,"New Orleans-Metairie, LA (Metropolitan Statistical Area)",2013,44945,174700,1087,175787,173613,55713717,1239584,96.2,97.3,97.6,94,97.1
2538,35620,"New York-Newark-Jersey City, NY-NJ-PA (Metropolitan Statistical Area)",2013,60684,406700,978,407678,405722,1166746613,19226449,121.4,109.6,156.1,116.9,122.6
2539,35660,"Niles, MI (Metropolitan Statistical Area)",2013,38275,129300,3014,132314,126286,5975892,156129,89.5,97.8,68.1,93.6,90.3
2540,35840,"North Port-Sarasota-Bradenton, FL (Metropolitan Statistical Area)",2013,44917,170900,1630,172530,169270,32869881,731796,98.7,97.5,109.4,94,99.6
2541,35980,"Norwich-New London, CT (Metropolitan Statistical Area)",2013,49500,252900,3116,256016,249784,13512234,272976,101.6,98.1,114.3,98.8,102.5
2542,36100,"Ocala, FL (Metropolitan Statistical Area)",2013,31269,119400,2430,121830,116970,10477835,335083,91.3,97.5,78,94,92.2
2543,36140,"Ocean City, NJ (Metropolitan Statistical Area)",2013,49561,312800,6160,318960,306640,4732960,95498,107.1,102.2,113.7,107.8,108.1
2544,36220,"Odessa, TX (Metropolitan Statistical Area)",2013,43880,91200,3121,94321,88079,6566935,149656,94.7,97.5,89.9,94,95.6
2545,36260,"Ogden-Clearfield, UT (Metropolitan Statistical Area)",2013,35720,197700,1667,199367,196033,22190350,621224,96.2,96.6,85.1,102.2,97.1
2546,36420,"Oklahoma City, OK (Metropolitan Statistical Area)",2013,42900,130600,920,131520,129680,56634702,1320148,92.3,97.3,79.3,94,93.2
2547,36500,"Olympia-Lacey-Tumwater, WA (Metropolitan Statistical Area)",2013,42554,244900,2701,247601,242199,11142838,261852,105.7,106.7,111.2,102.1,106.7
2548,36540,"Omaha-Council Bluffs, NE-IA (Metropolitan Statistical Area)",2013,48698,145900,848,146748,145052,43529572,893864,94.1,97.6,87.3,93.5,94.9
2549,36740,"Orlando-Kissimmee-Sanford, FL (Metropolitan Statistical Area)",2013,35572,161800,959,162759,160841,80753814,2270149,97.8,97.5,104.6,94,98.7
2550,36780,"Oshkosh-Neenah, WI (Metropolitan Statistical Area)",2013,39862,141300,1735,143035,139565,6747883,169283,91.8,97.8,76.5,93.6,92.6
2551,36980,"Owensboro, KY (Metropolitan Statistical Area)",2013,37353,106300,2494,108794,103806,4346933,116373,87.5,96.9,61.5,94,88.3
2552,37100,"Oxnard-Thousand Oaks-Ventura, CA (Metropolitan Statistical Area)",2013,50453,442200,3164,445364,439036,42286159,838136,116.2,101.9,171.2,104.1,117.3
2553,37340,"Palm Bay-Melbourne-Titusville, FL (Metropolitan Statistical Area)",2013,37919,144900,2174,147074,142726,20865017,550255,94.9,97.5,91.9,94,95.8
2554,37460,"Panama City, FL (Metropolitan Statistical Area)",2013,37369,155800,3337,159137,152463,6524445,174596,95.3,96.6,94.6,94.1,96.2
2555,37620,"Parkersburg-Vienna, WV (Metropolitan Statistical Area)",2013,35603,104100,2813,106913,101287,3288268,92360,85.9,97.3,56,94,86.7
2556,37860,"Pensacola-Ferry Pass-Brent, FL (Metropolitan Statistical Area)",2013,36694,142700,2244,144944,140456,17139438,467086,94.4,97.5,89.7,94,95.3
2557,37900,"Peoria, IL (Metropolitan Statistical Area)",2013,43092,128500,1712,130212,126788,18016318,418092,91.4,97.6,73.8,93.5,92.2
2558,37980,"Philadelphia-Camden-Wilmington, PA-NJ-DE-MD (Metropolitan Statistical Area)",2013,53544,240200,636,240836,239564,322875186,6030134,106.6,102.2,112.6,107.8,107.6
2559,38060,"Phoenix-Mesa-Chandler, AZ (Metropolitan Statistical Area)",2013,38231,170700,708,171408,169992,168334414,4403121,97.5,98.1,98.1,96.4,98.4
2560,38220,"Pine Bluff, AR (Metropolitan Statistical Area)",2013,30990,78400,2917,81317,75483,2967862,95769,84.4,96.6,52.8,94.1,85.2
2561,38300,"Pittsburgh, PA (Metropolitan Statistical Area)",2013,47147,124800,639,125439,124161,111257663,2359803,94.9,98.1,78.4,99.4,95.8
2562,38340,"Pittsfield, MA (Metropolitan Statistical Area)",2013,45638,206600,4127,210727,202473,5909602,129488,96.8,98.1,91.1,98.8,97.7
2563,38540,"Pocatello, ID (Metropolitan Statistical Area)",2013,32051,142600,3003,145603,139597,2924545,91246,89.7,98.8,71.3,94.2,90.6
2564,38860,"Portland-South Portland, ME (Metropolitan Statistical Area)",2013,46321,232800,1909,234709,230891,24086063,519987,101,98.3,109.6,99.5,102
2565,38900,"Portland-Vancouver-Hillsboro, OR-WA (Metropolitan Statistical Area)",2013,44577,267500,1288,268788,266212,103018264,2311015,101,98.6,111.4,99.4,101.9
2566,38940,"Port St. Lucie, FL (Metropolitan Statistical Area)",2013,43288,144100,2740,146840,141360,18891995,436425,95.7,97.5,95.1,94,96.6
2567,39300,"Providence-Warwick, RI-MA (Metropolitan Statistical Area)",2013,45590,259500,1153,260653,258347,73283570,1607460,99.6,98.6,100.1,100.5,100.5
2568,39340,"Provo-Orem, UT (Metropolitan Statistical Area)",2013,30926,220800,1631,222431,219169,17365996,561534,97.9,96.4,92.8,102.6,98.8
2569,39380,"Pueblo, CO (Metropolitan Statistical Area)",2013,32081,138700,2525,141225,136175,5166121,161033,93.6,96.4,74.7,102.7,94.4
2570,39460,"Punta Gorda, FL (Metropolitan Statistical Area)",2013,34759,143700,3714,147414,139986,5723831,164671,95,97.5,92.1,94,95.9
2571,39540,"Racine, WI (Metropolitan Statistical Area)",2013,40843,170100,2100,172200,168000,7951327,194680,94.1,95.8,87.6,95,94.9
2572,39580,"Raleigh-Cary, NC (Metropolitan Statistical Area)",2013,45333,205400,2021,207421,203379,55012077,1213499,95.6,97.5,94.4,94,96.5
2573,39660,"Rapid City, SD (Metropolitan Statistical Area)",2013,42077,157600,2497,160097,155103,5567592,132320,92.3,96.5,82.9,92.7,93.1
2574,39740,"Reading, PA (Metropolitan Statistical Area)",2013,41099,170600,1553,172153,169047,17011482,413915,96.5,98.1,89.8,98.8,97.4
2575,39820,"Redding, CA (Metropolitan Statistical Area)",2013,37184,220000,3384,223384,216616,6633514,178397,98.8,96.4,97.7,102.8,99.8
2576,39900,"Reno, NV (Metropolitan Statistical Area)",2013,43631,202700,3238,205938,199462,18974275,434878,99.9,96.4,102.9,102.7,100.8
2577,40060,"Richmond, VA (Metropolitan Statistical Area) *",2013,47671,219000,1321,220321,217679,58280354,1222549,96.2,97.4,97.7,94,97.1
2578,40140,"Riverside-San Bernardino-Ontario, CA (Metropolitan Statistical Area)",2013,33015,227300,992,228292,226308,144258043,4369493,107.4,101.9,120.5,104.1,108.4
2579,40220,"Roanoke, VA (Metropolitan Statistical Area) *",2013,40624,170100,1860,171960,168240,12669598,311878,90.5,96.7,74.6,94.1,91.4
2580,40340,"Rochester, MN (Metropolitan Statistical Area)",2013,46559,166300,1420,167720,164880,9847271,211502,92.9,96.4,85,92.7,93.8
2581,40380,"Rochester, NY (Metropolitan Statistical Area)",2013,43118,130100,877,130977,129223,46642389,1081736,97.8,98.1,95.5,98.8,98.8
2582,40420,"Rockford, IL (Metropolitan Statistical Area)",2013,37254,128100,1417,129517,126683,12841077,344692,91.6,97.8,76.9,93.6,92.5
2583,40580,"Rocky Mount, NC (Metropolitan Statistical Area)",2013,33710,98300,2015,100315,96285,5051274,149843,87,97.5,59,94,87.8
2584,40660,"Rome, GA (Metropolitan Statistical Area)",2013,32356,114800,4110,118910,110690,3102300,95880,81.6,91.4,60.1,94,82.3
2585,40900,"Sacramento-Roseville-Folsom, CA (Metropolitan Statistical Area)",2013,45885,272200,1314,273514,270886,101428315,2210512,103,96.4,120.3,102.8,103.9
2586,40980,"Saginaw, MI (Metropolitan Statistical Area)",2013,32986,97800,1444,99244,96356,6491489,196794,89.4,97.8,67.2,93.6,90.3
2587,41060,"St. Cloud, MN (Metropolitan Statistical Area)",2013,39647,165700,1381,167081,164319,7594535,191552,93.6,97.8,85.5,93.6,94.5
2588,41100,"St. George, UT (Metropolitan Statistical Area)",2013,29292,212900,5118,218018,207782,4305593,146987,94.6,98.8,88.9,94.2,95.5
2589,41140,"St. Joseph, MO-KS (Metropolitan Statistical Area)",2013,34918,111000,2502,113502,108498,4456791,127635,88.8,97.2,66.8,93.2,89.7
2590,41180,"St. Louis, MO-IL (Metropolitan Statistical Area)",2013,46270,158100,656,158756,157444,129532524,2799472,90.7,94.3,83.8,90.6,91.6
2591,41420,"Salem, OR (Metropolitan Statistical Area)",2013,33953,196500,1842,198342,194658,13513784,398015,96.1,98.6,84.7,99.4,97
2592,41500,"Salinas, CA (Metropolitan Statistical Area)",2013,45784,362400,6395,368795,356005,19536646,426712,108.1,96.4,153.4,102.8,109.2
2593,41540,"Salisbury, MD-DE (Metropolitan Statistical Area)",2013,40862,219900,3046,222946,216854,15714034,384567,90,91.4,84.3,94,90.8
2594,41620,"Salt Lake City, UT (Metropolitan Statistical Area)",2013,41118,228700,1186,229886,227514,46874998,1140025,100.1,96.5,104.7,102.5,101.1
2595,41660,"San Angelo, TX (Metropolitan Statistical Area)",2013,41160,98800,3590,102390,95210,4837071,117519,92.4,97.5,79.9,94,93.2
2596,41700,"San Antonio-New Braunfels, TX (Metropolitan Statistical Area)",2013,39950,131100,1148,132248,129952,91085006,2280002,94.1,97.2,88.5,94,95
2597,41740,"San Diego-Chula Vista-Carlsbad, CA (Metropolitan Statistical Area)",2013,49525,402100,2178,404278,399922,158965053,3209768,117,102.3,162.9,105.2,118.1
2598,41860,"San Francisco-Oakland-Berkeley, CA (Metropolitan Statistical Area)",2013,71255,579300,2492,581792,576808,322045787,4519636,122,109.4,181.7,109.3,123.2
2599,41940,"San Jose-Sunnyvale-Santa Clara, CA (Metropolitan Statistical Area)",2013,71988,636900,2903,639803,633997,138480357,1923664,123.5,109.2,194.7,109.1,124.6
2600,42020,"San Luis Obispo-Paso Robles, CA (Metropolitan Statistical Area)",2013,45968,426600,7344,433944,419256,12673213,275696,107.2,96.4,147.9,102.8,108.2
2601,42100,"Santa Cruz-Watsonville, CA (Metropolitan Statistical Area)",2013,54062,557500,9596,567096,547904,14532865,268816,122.5,109.4,172.1,109.3,123.6
2602,42140,"Santa Fe, NM (Metropolitan Statistical Area)",2013,47085,278400,4499,282899,273901,6943346,147465,100.2,96.4,104.9,102.7,101.2
2603,42200,"Santa Maria-Santa Barbara, CA (Metropolitan Statistical Area)",2013,50714,453000,10723,463723,442277,22040352,434601,109,96.4,166.6,102.8,110
2604,42220,"Santa Rosa-Petaluma, CA (Metropolitan Statistical Area)",2013,48610,407400,4973,412373,402427,24016769,494073,118.6,109.4,150.5,109.3,119.7
2605,42340,"Savannah, GA (Metropolitan Statistical Area)",2013,40000,171100,2237,173337,168863,14604110,365103,94.9,97.5,91.6,94,95.8
2606,42540,"Scranton--Wilkes-Barre, PA (Metropolitan Statistical Area)",2013,38544,131000,1507,132507,129493,21642455,561495,92.3,98.1,72.3,98.8,93.2
2607,42660,"Seattle-Tacoma-Bellevue, WA (Metropolitan Statistical Area)",2013,56551,321500,1243,322743,320257,204281077,3612347,108.3,106.7,128.2,102.1,109.3
2608,42680,"Sebastian-Vero Beach, FL (Metropolitan Statistical Area)",2013,60557,157400,3964,161364,153436,8592769,141895,91.1,91.4,87.4,94,91.9
2609,42700,"Sebring-Avon Park, FL (Metropolitan Statistical Area)",2013,29737,93600,3520,97120,90080,2916520,98077,85.7,91.4,72.7,94,86.5
2610,43100,"Sheboygan, WI (Metropolitan Statistical Area)",2013,43351,152300,2011,154311,150289,4972269,114697,91.1,97.8,73.9,93.6,92
2611,43300,"Sherman-Denison, TX (Metropolitan Statistical Area)",2013,36117,104500,3463,107963,101037,4419341,122362,90.6,97.5,72.5,94,91.4
2612,43340,"Shreveport-Bossier City, LA (Metropolitan Statistical Area)",2013,41951,120600,2302,122902,118298,17042125,406237,90.3,97.3,71.8,94,91.1
2613,43420,"Sierra Vista-Douglas, AZ (Metropolitan Statistical Area)",2013,34557,146200,4583,150783,141617,4477829,129578,92,98.8,79,94.2,92.9
2614,43580,"Sioux City, IA-NE-SD (Metropolitan Statistical Area)",2013,41183,105900,2086,107986,103814,5914811,143623,89.3,95.8,68.1,92.3,90.2
2615,43620,"Sioux Falls, SD (Metropolitan Statistical Area)",2013,48094,154400,1806,156206,152594,11627843,241772,92.7,97.6,80.7,93.4,93.6
2616,43780,"South Bend-Mishawaka, IN-MI (Metropolitan Statistical Area)",2013,38658,116800,1775,118575,115025,12317993,318639,90.6,97.2,74.6,93.1,91.5
2617,43900,"Spartanburg, SC (Metropolitan Statistical Area)",2013,35181,115900,1989,117889,113911,10217192,290414,87.7,97.2,64.1,94,88.6
2618,44060,"Spokane-Spokane Valley, WA (Metropolitan Statistical Area)",2013,37694,183800,1534,185334,182266,19661078,521603,96.1,96.7,84.6,101.6,97
2619,44100,"Springfield, IL (Metropolitan Statistical Area)",2013,42104,125700,2057,127757,123643,8913926,211713,92,97.8,74.4,93.6,92.8
2620,44140,"Springfield, MA (Metropolitan Statistical Area)",2013,43584,215600,1803,217403,213797,30507279,699964,97,98.1,92.4,98.8,98
2621,44180,"Springfield, MO (Metropolitan Statistical Area)",2013,34471,128200,1507,129707,126693,15457665,448427,88.9,97.4,68.2,93.4,89.8
2622,44220,"Springfield, OH (Metropolitan Statistical Area)",2013,35066,106400,2171,108571,104229,4791313,136638,88.9,97.8,65.4,93.6,89.8
2623,44300,"State College, PA (Metropolitan Statistical Area)",2013,39660,192600,3297,195897,189303,6275406,158231,102.8,98.1,120.6,98.8,103.8
2624,44420,"Staunton, VA (Metropolitan Statistical Area) *",2013,37745,184800,3568,188368,181232,4495862,119110,88.5,91.4,79.4,94,89.3
2625,44700,"Stockton, CA (Metropolitan Statistical Area)",2013,35715,208000,2857,210857,205143,25073348,702046,101,96.4,108.7,102.8,102
2626,44940,"Sumter, SC (Metropolitan Statistical Area)",2013,32356,107300,4525,111825,102775,4594793,142007,88.5,97.5,67.5,94,89.3
2627,45060,"Syracuse, NY (Metropolitan Statistical Area)",2013,41271,122900,1046,123946,121854,27312050,661773,95.7,98.1,86.1,98.8,96.6
2628,45220,"Tallahassee, FL (Metropolitan Statistical Area)",2013,35320,167000,2143,169143,164857,13181006,373187,94.9,97.1,92.5,94,95.8
2629,45300,"Tampa-St. Petersburg-Clearwater, FL (Metropolitan Statistical Area)",2013,39635,146500,995,147495,145505,114169041,2880536,101.1,97.6,104.4,103.2,102.1
2630,45460,"Terre Haute, IN (Metropolitan Statistical Area)",2013,32890,87500,1652,89152,85848,6219114,189089,87.6,97.3,62.4,93.3,88.4
2631,45500,"Texarkana, TX-AR (Metropolitan Statistical Area)",2013,32907,92700,2647,95347,90053,4919949,149509,87.8,96.4,61.8,94.2,88.6
2632,45540,"The Villages, FL (Metropolitan Statistical Area)",2013,37282,194100,4955,199055,189145,3985332,106898,88.6,91.4,82.9,94,89.4
2633,45780,"Toledo, OH (Metropolitan Statistical Area)",2013,39219,118200,1178,119378,117022,25429407,648403,89.8,97.8,68.8,93.6,90.7
2634,45820,"Topeka, KS (Metropolitan Statistical Area)",2013,39272,118800,1803,120603,116997,9183310,233838,89.3,96.9,69.7,92.9,90.2
2635,45940,"Trenton-Princeton, NJ (Metropolitan Statistical Area)",2013,58096,286900,3275,290175,283625,21462400,369429,111.5,102.3,122.4,115.2,112.6
2636,46060,"Tucson, AZ (Metropolitan Statistical Area)",2013,36758,167500,1056,168556,166444,36652520,997127,97.8,96.4,92.3,102.7,98.7
2637,46140,"Tulsa, OK (Metropolitan Statistical Area)",2013,55685,127800,1006,128806,126794,53563843,961904,90.9,97.4,73.3,94,91.8
2638,46220,"Tuscaloosa, AL (Metropolitan Statistical Area)",2013,33856,140600,2735,143335,137865,8273770,244378,88,96.4,64.2,94.1,88.8
2639,46300,"Twin Falls, ID (Metropolitan Statistical Area)",2013,34171,146300,3005,149305,143295,3508091,102662,(NA),(NA),(NA),(NA),(NA)
2640,46340,"Tyler, TX (Metropolitan Statistical Area)",2013,48849,120800,3016,123816,117784,10574695,216475,94.5,97.5,89.1,94,95.4
2641,46520,"Urban Honolulu, HI (Metropolitan Statistical Area)",2013,48530,556300,3584,559884,552716,47853464,986059,124.9,113.8,176.4,108.2,126.1
2642,46540,"Utica-Rome, NY (Metropolitan Statistical Area)",2013,37857,105900,1611,107511,104289,11252310,297230,93.1,98.1,75.1,98.8,94
2643,46660,"Valdosta, GA (Metropolitan Statistical Area)",2013,30520,125200,3480,128680,121720,4362393,142937,82.7,91.4,65,94,83.5
2644,46700,"Vallejo, CA (Metropolitan Statistical Area)",2013,40968,262400,3512,265912,258888,17356635,423659,116.3,109.4,137.9,109.3,117.4
2645,47020,"Victoria, TX (Metropolitan Statistical Area)",2013,43286,110300,3811,114111,106489,4221163,97518,92.8,97.2,81.6,94,93.7
2646,47220,"Vineland-Bridgeton, NJ (Metropolitan Statistical Area)",2013,34467,168900,2542,171442,166358,5380301,156098,101.7,102.2,92.3,107.8,102.7
2647,47260,"Virginia Beach-Norfolk-Newport News, VA-NC (Metropolitan Statistical Area) *",2013,43275,240000,1191,241191,238809,75358367,1741366,98.7,97.5,109,94,99.6
2648,47300,"Visalia, CA (Metropolitan Statistical Area)",2013,32977,163100,1901,165001,161199,14920564,452460,96,96.4,84.7,102.7,96.9
2649,47380,"Waco, TX (Metropolitan Statistical Area)",2013,34096,104200,2365,106565,101835,8820096,258685,91.2,96.8,75.4,94.1,92
2650,47460,"Walla Walla, WA (Metropolitan Statistical Area)",2013,38325,190700,8266,198966,182434,2275022,59361,92.9,98.8,81,94.1,93.8
2651,47580,"Warner Robins, GA (Metropolitan Statistical Area)",2013,36120,128400,3593,131993,124807,6309781,174689,89.5,96.9,69.8,94.1,90.3
2652,47900,"Washington-Arlington-Alexandria, DC-VA-MD-WV (Metropolitan Statistical Area) *",2013,61313,373100,941,374041,372159,365630308,5963312,119,105.9,169.6,109.8,120.1
2653,47940,"Waterloo-Cedar Falls, IA (Metropolitan Statistical Area)",2013,39974,126800,2153,128953,124647,6789775,169853,91.1,96.8,76.7,92.8,92
2654,48060,"Watertown-Fort Drum, NY (Metropolitan Statistical Area)",2013,42259,131800,3217,135017,128583,5007219,118490,99.1,98.1,101.2,98.8,100
2655,48140,"Wausau-Weston, WI (Metropolitan Statistical Area)",2013,41126,142300,2042,144342,140258,6711272,163189,91.9,97.8,75.1,93.6,92.8
2656,48260,"Weirton-Steubenville, WV-OH (Metropolitan Statistical Area)",2013,34198,85200,1383,86583,83817,4176876,122139,86.7,97.8,55.4,93.6,87.5
2657,48300,"Wenatchee, WA (Metropolitan Statistical Area)",2013,39229,233800,5539,239339,228261,4437165,113110,96,98.8,93.7,94.2,96.9
2658,48540,"Wheeling, WV-OH (Metropolitan Statistical Area)",2013,36984,90300,1810,92110,88490,5397301,145938,85.1,97.5,52,94,85.9
2659,48620,"Wichita, KS (Metropolitan Statistical Area)",2013,46266,121600,1154,122754,120446,29164714,630365,90.9,97.6,72.9,93.4,91.8
2660,48660,"Wichita Falls, TX (Metropolitan Statistical Area)",2013,42706,89400,1847,91247,87553,6467695,151448,90.9,97.2,75.1,94,91.8
2661,48700,"Williamsport, PA (Metropolitan Statistical Area)",2013,38279,131000,2274,133274,128726,4463239,116598,93.8,98.1,79,98.8,94.7
2662,48900,"Wilmington, NC (Metropolitan Statistical Area)",2013,36459,201500,4356,205856,197144,9759953,267700,94.8,96.8,92.3,94,95.7
2663,49020,"Winchester, VA-WV (Metropolitan Statistical Area) *",2013,39606,207200,6148,213348,201052,5238992,132278,92.3,91.4,91.6,94,93.2
2664,49180,"Winston-Salem, NC (Metropolitan Statistical Area)",2013,37106,142800,1314,144114,141486,24115223,649901,90,97.5,70.3,94,90.9
2665,49340,"Worcester, MA-CT (Metropolitan Statistical Area)",2013,46453,251200,1893,253093,249307,43124790,928346,103.5,100.5,104.5,106.3,104.5
2666,49420,"Yakima, WA (Metropolitan Statistical Area)",2013,35817,156300,2528,158828,153772,8828355,246485,95.6,96.4,81.7,102.7,96.5
2667,49620,"York-Hanover, PA (Metropolitan Statistical Area)",2013,41827,174200,1479,175679,172721,18359096,438932,96.3,98.1,88.4,98.8,97.2
2668,49660,"Youngstown-Warren-Boardman, OH-PA (Metropolitan Statistical Area)",2013,36331,98000,917,98917,97083,20194642,555850,88.4,97.9,62.1,94.7,89.2
2669,49700,"Yuba City, CA (Metropolitan Statistical Area)",2013,36103,179200,4717,183917,174483,6050781,167597,99.3,96.4,99.6,102.8,100.2
2670,49740,"Yuma, AZ (Metropolitan Statistical Area) *",2013,29081,118000,2192,120192,115808,5886587,202420,94,96.4,77.1,102.7,94.9
2671,10180,"Abilene, TX (Metropolitan Statistical Area)",2012,37963,89300,2515,91815,86785,6356517,167442,91.4,97,77.1,94.2,91
2672,10420,"Akron, OH (Metropolitan Statistical Area)",2012,41108,141500,1199,142699,140301,28861978,702109,88.8,94.6,77.7,88.5,88.4
2673,10500,"Albany, GA (Metropolitan Statistical Area)",2012,33133,104500,3110,107610,101390,5101696,153976,84.6,96.8,56.3,94.2,84.2
2674,10540,"Albany-Lebanon, OR (Metropolitan Statistical Area)",2012,33519,176800,4422,181222,172378,3964446,118273,93.1,98.7,84.3,93.4,92.7
2675,10580,"Albany-Schenectady-Troy, NY (Metropolitan Statistical Area)",2012,47539,197900,1492,199392,196408,41582543,874698,99.1,97.9,104.3,98,98.6
2676,10740,"Albuquerque, NM (Metropolitan Statistical Area) *",2012,35950,182100,1467,183567,180633,32424855,901939,97.2,97,90.4,101.3,96.7
2677,10780,"Alexandria, LA (Metropolitan Statistical Area)",2012,38363,112100,3291,115391,108809,5923309,154400,87.7,97.1,63,94.2,87.2
2678,10900,"Allentown-Bethlehem-Easton, PA-NJ (Metropolitan Statistical Area)",2012,44157,213400,1358,214758,212042,36480137,826144,99.9,98.4,101,101.1,99.4
2679,11020,"Altoona, PA (Metropolitan Statistical Area)",2012,37997,103700,2366,106066,101334,4808282,126544,91.6,97.9,68.3,98,91.2
2680,11100,"Amarillo, TX (Metropolitan Statistical Area)",2012,40340,113600,1952,115552,111648,10399720,257802,93,97.4,82.3,94.3,92.6
2681,11180,"Ames, IA (Metropolitan Statistical Area)",2012,40384,160700,2931,163631,157769,4770974,118139,89.7,92.1,87,89.2,89.3
2682,11260,"Anchorage, AK (Metropolitan Statistical Area)",2012,55931,258900,2945,261845,255955,21920977,391932,108.4,102.8,141.1,101.5,107.9
2683,11460,"Ann Arbor, MI (Metropolitan Statistical Area)",2012,47792,200300,2722,203022,197578,16837310,352303,101.7,99.1,112.5,100,101.2
2684,11500,"Anniston-Oxford, AL (Metropolitan Statistical Area)",2012,32401,101900,3148,105048,98752,3797108,117190,85,97.6,53.3,94.4,84.6
2685,11540,"Appleton, WI (Metropolitan Statistical Area)",2012,42252,158200,1704,159904,156496,9661257,228656,93.4,97.7,81.2,94.4,92.9
2686,11700,"Asheville, NC (Metropolitan Statistical Area)",2012,36586,183200,2872,186072,180328,15766749,430945,92.2,95.9,84.3,93.9,91.8
2687,12020,"Athens-Clarke County, GA (Metropolitan Statistical Area)",2012,32015,166100,2324,168424,163776,6274463,195984,91.5,97.3,78.6,94.3,91.1
2688,12060,"Atlanta-Sandy Springs-Alpharetta, GA (Metropolitan Statistical Area)",2012,41628,177300,898,178198,176402,226640964,5444473,95.9,98.1,93.1,95.3,95.4
2689,12100,"Atlantic City-Hammonton, NJ (Metropolitan Statistical Area)",2012,41831,248100,3154,251254,244946,11488052,274629,107.1,102.9,110.8,108.7,106.6
2690,12220,"Auburn-Opelika, AL (Metropolitan Statistical Area)",2012,31867,149300,4225,153525,145075,4734318,148567,86.8,91.9,75.5,92.6,86.3
2691,12260,"Augusta-Richmond County, GA-SC (Metropolitan Statistical Area)",2012,34899,125000,2047,127047,122953,20109207,576206,89.6,97.2,69.8,94.3,89.1
2692,12420,"Austin-Round Rock-Georgetown, TX (Metropolitan Statistical Area)",2012,46679,189200,1220,190420,187980,85635903,1834586,98.5,97.6,108.9,94.4,98
2693,12540,"Bakersfield, CA (Metropolitan Statistical Area)",2012,34522,171200,1652,172852,169548,29468514,853606,98,96.9,94.6,101.3,97.6
2694,12580,"Baltimore-Columbia-Towson, MD (Metropolitan Statistical Area)",2012,52171,289400,1241,290641,288159,143713198,2754637,107.6,102.2,115.6,107.9,107.1
2695,12620,"Bangor, ME (Metropolitan Statistical Area)",2012,35136,138000,3014,141014,134986,5387976,153347,96.6,97.9,92.3,98,96.1
2696,12700,"Barnstable Town, MA (Metropolitan Statistical Area)",2012,58176,373600,3742,377342,369858,12495574,214788,102.1,97.9,118.2,98,101.6
2697,12940,"Baton Rouge, LA (Metropolitan Statistical Area)",2012,41134,157100,1457,158557,155643,34395833,836197,93.1,96.6,85.2,94.1,92.7
2698,12980,"Battle Creek, MI (Metropolitan Statistical Area)",2012,33886,102800,1924,104724,100876,4565662,134737,90.8,97.7,72,94.4,90.4
2699,13020,"Bay City, MI (Metropolitan Statistical Area)",2012,35192,99200,1857,101057,97343,3764382,106967,89,97.7,64.4,94.4,88.6
2700,13140,"Beaumont-Port Arthur, TX (Metropolitan Statistical Area)",2012,38432,93900,1498,95398,92402,14973569,389614,90.2,97.2,70.2,94.3,89.8
2701,13220,"Beckley, WV (Metropolitan Statistical Area)",2012,34156,89400,3351,92751,86049,4273243,125110,76.6,91.9,47.3,92.6,76.3
2702,13380,"Bellingham, WA (Metropolitan Statistical Area)",2012,40558,281400,4275,285675,277125,8308744,204863,99.9,96.9,104.1,101.3,99.4
2703,13460,"Bend, OR (Metropolitan Statistical Area)",2012,39383,271600,6804,278404,264796,6354749,161359,95.4,98.7,92.9,93.4,95
2704,13740,"Billings, MT (Metropolitan Statistical Area)",2012,44294,178700,2059,180759,176641,7571769,170942,95.8,97,83.6,100.9,95.3
2705,13780,"Binghamton, NY (Metropolitan Statistical Area)",2012,37999,105900,1683,107583,104217,9459605,248945,95.5,97.9,86.4,98,95
2706,13820,"Birmingham-Hoover, AL (Metropolitan Statistical Area)",2012,42793,144800,1390,146190,143410,45684227,1067563,90,97.3,70.5,94.3,89.6
2707,13900,"Bismarck, ND (Metropolitan Statistical Area)",2012,51447,157800,2119,159919,155681,5951371,115679,92.4,97.4,77.5,94.1,91.9
2708,13980,"Blacksburg-Christiansburg, VA (Metropolitan Statistical Area) *",2012,31581,159000,3540,162540,155460,5183007,164120,88.9,91.9,79.8,92.7,88.5
2709,14020,"Bloomington, IN (Metropolitan Statistical Area)",2012,33455,130300,3380,133680,126920,5448213,162852,95.1,97.2,93.1,93.9,94.6
2710,14100,"Bloomsburg-Berwick, PA (Metropolitan Statistical Area)",2012,37711,138200,2809,141009,135391,3223207,85472,92.6,97.9,74,98,92.1
2711,14260,"Boise City, ID (Metropolitan Statistical Area)",2012,36498,173400,1460,174860,171940,23264918,637425,95.4,97,81.8,101.1,94.9
2712,14460,"Boston-Cambridge-Newton, MA-NH (Metropolitan Statistical Area)",2012,62503,366400,850,367250,365550,291048881,4656593,110.9,100.5,140.7,108.7,110.4
2713,14500,"Boulder, CO (Metropolitan Statistical Area) *",2012,54984,354300,3964,358264,350336,16746365,304570,108.6,102,138,99.8,108.1
2714,14540,"Bowling Green, KY (Metropolitan Statistical Area)",2012,31891,134700,2948,137648,131752,5180670,162450,85.4,92,64.3,92.7,84.9
2715,14740,"Bremerton-Silverdale-Port Orchard, WA (Metropolitan Statistical Area)",2012,44724,276500,3222,279722,273278,11375132,254339,104.9,105.6,111.8,101.3,104.4
2716,14860,"Bridgeport-Stamford-Norwalk, CT (Metropolitan Statistical Area)",2012,103660,447500,4096,451596,443404,96932032,935099,120.6,111.2,146.6,120.3,120
2717,15180,"Brownsville-Harlingen, TX (Metropolitan Statistical Area)",2012,24594,76600,1208,77808,75392,10228234,415877,85,97.6,58,94.4,84.6
2718,15260,"Brunswick, GA (Metropolitan Statistical Area)",2012,33429,143200,8380,151580,134820,3786846,113281,85.6,91.9,71.4,92.6,85.2
2719,15380,"Buffalo-Cheektowaga, NY (Metropolitan Statistical Area)",2012,41821,119700,764,120464,118936,47450812,1134619,93.7,97.9,78,98,93.3
2720,15500,"Burlington, NC (Metropolitan Statistical Area)",2012,34309,136500,3194,139694,133306,5258423,153265,89.8,97.6,70.3,94.4,89.4
2721,15540,"Burlington-South Burlington, VT (Metropolitan Statistical Area)",2012,48371,249700,2830,252530,246870,10349481,213962,102,97.9,119.2,98,101.5
2722,15940,"Canton-Massillon, OH (Metropolitan Statistical Area)",2012,37878,123300,1187,124487,122113,15281159,403429,89.4,97.7,65.2,94.4,88.9
2723,15980,"Cape Coral-Fort Myers, FL (Metropolitan Statistical Area)",2012,41715,161400,2021,163421,159379,26872504,644197,95.2,97.6,92.3,94.4,94.8
2724,16020,"Cape Girardeau, MO-IL (Metropolitan Statistical Area)",2012,36576,123100,3133,126233,119967,3555557,97210,84,92.1,67.9,89.2,83.6
2725,16060,"Carbondale-Marion, IL (Metropolitan Statistical Area)",2012,35402,96900,4153,101053,92747,4910127,138698,84.4,92.1,68.9,89.2,84
2726,16180,"Carson City, NV (Metropolitan Statistical Area)",2012,39473,221900,7023,228923,214877,2143871,54312,97.1,98.7,100,93.4,96.6
2727,16220,"Casper, WY (Metropolitan Statistical Area)",2012,60329,179100,3325,182425,175775,4739759,78565,98.3,96.9,95.8,101.3,97.8
2728,16300,"Cedar Rapids, IA (Metropolitan Statistical Area)",2012,44833,140100,1579,141679,138521,11742464,261916,91.6,97,75.3,93.8,91.1
2729,16540,"Chambersburg-Waynesboro, PA (Metropolitan Statistical Area)",2012,38640,178200,2901,181101,175299,5853276,151482,94.4,97.9,81.9,98,94
2730,16580,"Champaign-Urbana, IL (Metropolitan Statistical Area)",2012,40549,142200,2241,144441,139959,8966705,221131,93.9,97.1,87.1,93.9,93.4
2731,16620,"Charleston, WV (Metropolitan Statistical Area)",2012,38670,102400,1937,104337,100463,10700132,276704,89.9,97.2,67.6,94.2,89.5
2732,16700,"Charleston-North Charleston, SC (Metropolitan Statistical Area)",2012,41605,189700,2179,191879,187521,28991994,696839,95.8,97.6,95,94.4,95.4
2733,16740,"Charlotte-Concord-Gastonia, NC-SC (Metropolitan Statistical Area)",2012,44906,171100,917,172017,170183,104121182,2318671,93.3,97.2,84,94.3,92.9
2734,16820,"Charlottesville, VA (Metropolitan Statistical Area) *",2012,52167,277900,4091,281991,273809,10721973,205532,98.2,96.8,110.5,94.2,97.7
2735,16860,"Chattanooga, TN-GA (Metropolitan Statistical Area)",2012,39302,141600,1529,143129,140071,21148282,538103,90.5,97.4,72.4,94.3,90
2736,16940,"Cheyenne, WY (Metropolitan Statistical Area)",2012,48466,177600,3367,180967,174233,4589574,94697,96.8,96.9,87.9,101.3,96.4
2737,16980,"Chicago-Naperville-Elgin, IL-IN-WI (Metropolitan Statistical Area)",2012,48761,236800,552,237352,236248,464594859,9528090,106.3,103.5,117.5,104.1,105.8
2738,17020,"Chico, CA (Metropolitan Statistical Area)",2012,35234,237400,4521,241921,232879,7782000,220869,100.7,96.9,108.2,101.3,100.2
2739,17140,"Cincinnati, OH-KY-IN (Metropolitan Statistical Area)",2012,44811,155700,781,156481,154919,96458171,2152554,90.3,92.5,80.3,93,89.9
2740,17300,"Clarksville, TN-KY (Metropolitan Statistical Area)",2012,38274,128600,1747,130347,126853,10999761,287393,91.1,97.4,76.5,94.3,90.6
2741,17420,"Cleveland, TN (Metropolitan Statistical Area)",2012,34268,133200,4207,137407,128993,4032439,117673,83.7,91.9,66.6,92.6,83.3
2742,17460,"Cleveland-Elyria, OH (Metropolitan Statistical Area)",2012,44373,145600,679,146279,144921,91619842,2064776,89.5,94.6,81.2,88.5,89.1
2743,17660,"Coeur d'Alene, ID (Metropolitan Statistical Area)",2012,35516,201400,5190,206590,196210,5046300,142084,92.9,98.7,83,93.4,92.5
2744,17780,"College Station-Bryan, TX (Metropolitan Statistical Area)",2012,33117,139800,3566,143366,136234,7754340,234148,94.2,97.1,89.8,94.2,93.8
2745,17820,"Colorado Springs, CO (Metropolitan Statistical Area)",2012,41216,218100,2009,220109,216091,27591746,669448,99.2,97,100.8,101.1,98.7
2746,17860,"Columbia, MO (Metropolitan Statistical Area)",2012,39387,156000,2209,158209,153791,7741194,196540,92.9,97.7,80.7,94.4,92.5
2747,17900,"Columbia, SC (Metropolitan Statistical Area)",2012,36945,139000,1309,140309,137691,28937368,783250,92.2,97.1,80.4,94.2,91.8
2748,17980,"Columbus, GA-AL (Metropolitan Statistical Area)",2012,34760,132100,2685,134785,129415,11217622,322721,89.1,97.5,69.7,94.3,88.7
2749,18020,"Columbus, IN (Metropolitan Statistical Area)",2012,43199,137000,2877,139877,134123,3412769,79001,88.6,92.1,82.1,89.2,88.2
2750,18140,"Columbus, OH (Metropolitan Statistical Area)",2012,43654,162100,670,162770,161430,85002968,1947208,93.7,97.3,84.8,94.1,93.2
2751,18580,"Corpus Christi, TX (Metropolitan Statistical Area)",2012,40438,107300,1755,109055,105545,16708972,413199,92.7,97.4,81.7,94.3,92.2
2752,18700,"Corvallis, OR (Metropolitan Statistical Area)",2012,38294,272000,4981,276981,267019,3319288,86678,96.4,98.7,97.1,93.4,96
2753,18880,"Crestview-Fort Walton Beach-Destin, FL (Metropolitan Statistical Area)",2012,43396,188200,3879,192079,184321,10716781,246952,95.8,95.3,100.7,93.9,95.3
2754,19060,"Cumberland, MD-WV (Metropolitan Statistical Area)",2012,33708,119800,2907,122707,116893,3432618,101833,88,97.6,62.7,94.4,87.6
2755,19100,"Dallas-Fort Worth-Arlington, TX (Metropolitan Statistical Area)",2012,46644,149500,512,150012,148988,309930247,6644559,100.1,97.6,99.7,103.4,99.7
2756,19140,"Dalton, GA (Metropolitan Statistical Area)",2012,27666,115400,3179,118579,112221,3935770,142259,84.6,91.9,68.1,92.6,84.2
2757,19180,"Danville, IL (Metropolitan Statistical Area)",2012,34440,77200,2333,79533,74867,2784850,80862,80.7,92.1,57.5,89.2,80.3
2758,19300,"Daphne-Fairhope-Foley, AL (Metropolitan Statistical Area)",2012,38259,172900,2814,175714,170086,7274734,190145,93.1,97.6,84.8,94.4,92.7
2759,19340,"Davenport-Moline-Rock Island, IA-IL (Metropolitan Statistical Area)",2012,43412,123100,1318,124418,121782,16602255,382431,92,97.5,76.3,94.2,91.6
2760,19460,"Decatur, AL (Metropolitan Statistical Area)",2012,32935,115700,2523,118223,113177,5068995,153908,86.2,97.6,54.6,94.4,85.8
2761,19500,"Decatur, IL (Metropolitan Statistical Area)",2012,41666,92500,2234,94734,90266,4588870,110134,89.8,97.7,66,94.4,89.4
2762,19660,"Deltona-Daytona Beach-Ormond Beach, FL (Metropolitan Statistical Area)",2012,35418,158900,1704,160604,157196,21072330,594969,95.3,97.6,93.1,94.4,94.9
2763,19740,"Denver-Aurora-Lakewood, CO (Metropolitan Statistical Area) *",2012,49820,246900,843,247743,246057,132036059,2650274,103.7,102,113.4,99.7,103.2
2764,19780,"Des Moines-West Des Moines, IA (Metropolitan Statistical Area)",2012,45716,155600,1038,156638,154562,28653477,626778,94.8,97.5,89.1,94.2,94.3
2765,19820,"Detroit-Warren-Dearborn, MI (Metropolitan Statistical Area)",2012,42523,135700,652,136352,135048,182886313,4300864,97.6,99.1,88.9,100,97.1
2766,20020,"Dothan, AL (Metropolitan Statistical Area)",2012,35140,108300,2661,110961,105639,5181319,147448,84.7,96.4,55.7,94.1,84.3
2767,20100,"Dover, DE (Metropolitan Statistical Area)",2012,35687,205100,3675,208775,201425,5970367,167297,94.2,97.6,87.9,94.4,93.7
2768,20220,"Dubuque, IA (Metropolitan Statistical Area)",2012,41053,144300,2547,146847,141753,3906579,95159,92.5,97.7,78.9,94.4,92.1
2769,20260,"Duluth, MN-WI (Metropolitan Statistical Area)",2012,39398,142500,1834,144334,140666,11432368,290176,91.6,97.2,77.9,93.9,91.1
2770,20500,"Durham-Chapel Hill, NC (Metropolitan Statistical Area)",2012,44030,191500,2676,194176,188824,25613532,581735,95.1,97.4,91.6,94.3,94.6
2771,20700,"East Stroudsburg, PA (Metropolitan Statistical Area)",2012,33372,198400,4294,202694,194106,5627464,168628,98.4,97.9,100,98,97.9
2772,20740,"Eau Claire, WI (Metropolitan Statistical Area)",2012,40348,150000,2387,152387,147613,6612776,163892,92.5,97.7,78,94.4,92
2773,20940,"El Centro, CA (Metropolitan Statistical Area)",2012,32120,155800,3654,159454,152146,5671528,176575,91.3,98.7,77.6,93.4,90.9
2774,21060,"Elizabethtown-Fort Knox, KY (Metropolitan Statistical Area)",2012,35864,135500,4019,139519,131481,5433482,151501,86.9,91.9,75.6,92.6,86.4
2775,21140,"Elkhart-Goshen, IN (Metropolitan Statistical Area)",2012,34791,125900,1956,127856,123944,6922243,198968,91.9,97.7,76.6,94.4,91.5
2776,21300,"Elmira, NY (Metropolitan Statistical Area)",2012,37574,91800,2007,93807,89793,3349249,89137,94.4,97.9,81.3,98,93.9
2777,21340,"El Paso, TX (Metropolitan Statistical Area)",2012,30698,111000,972,111972,110028,25653500,835667,90.7,97.6,75.8,94.3,90.3
2778,21420,"Enid, OK (Metropolitan Statistical Area)",2012,44215,88600,3155,91755,85445,2714769,61399,(NA),(NA),(NA),(NA),(NA)
2779,21500,"Erie, PA (Metropolitan Statistical Area)",2012,38046,115400,1604,117004,113796,10711298,281532,92.9,97.9,75.8,98,92.5
2780,21660,"Eugene-Springfield, OR (Metropolitan Statistical Area)",2012,36360,226200,1912,228112,224288,12910394,355075,98.3,96.9,96.4,101.3,97.9
2781,21780,"Evansville, IN-KY (Metropolitan Statistical Area)",2012,41886,115400,1341,116741,114059,13128069,313422,91.5,97.7,73.3,94.4,91.1
2782,21820,"Fairbanks, AK (Metropolitan Statistical Area) *",2012,50958,213500,4896,218396,208604,5111638,100311,105.8,98.7,153.4,93.4,105.3
2783,22020,"Fargo, ND-MN (Metropolitan Statistical Area)",2012,47018,154400,1617,156017,152783,10231671,217610,93.7,97.7,83.8,94.4,93.3
2784,22140,"Farmington, NM (Metropolitan Statistical Area)",2012,32926,154300,3539,157839,150761,4272325,129756,91.8,98.7,76,93.4,91.4
2785,22180,"Fayetteville, NC (Metropolitan Statistical Area)",2012,33077,127600,2460,130060,125140,16626684,502672,91.5,97.2,79.1,94.2,91
2786,22220,"Fayetteville-Springdale-Rogers, AR (Metropolitan Statistical Area)",2012,49613,146000,1823,147823,144177,22935557,462291,90.7,97.4,72.5,94.2,90.2
2787,22380,"Flagstaff, AZ (Metropolitan Statistical Area)",2012,36815,237200,7964,245164,229236,5012242,136146,97.5,98.7,102.2,93.4,97
2788,22420,"Flint, MI (Metropolitan Statistical Area)",2012,33165,99900,1403,101303,98497,13869270,418193,93.6,99.1,71,100,93.2
2789,22500,"Florence, SC (Metropolitan Statistical Area)",2012,33326,101900,3377,105277,98523,6866558,206041,85.7,96.3,58,94,85.3
2790,22520,"Florence-Muscle Shoals, AL (Metropolitan Statistical Area)",2012,32743,108300,2755,111055,105545,4820865,147232,84.5,97.6,50.5,94.4,84.1
2791,22540,"Fond du Lac, WI (Metropolitan Statistical Area)",2012,40054,145800,2202,148002,143598,4077064,101788,87.1,92.1,76.5,89.2,86.7
2792,22660,"Fort Collins, CO (Metropolitan Statistical Area)",2012,40922,245200,2614,247814,242586,12720373,310842,101,96.9,111.1,101.3,100.5
2793,22900,"Fort Smith, AR-OK (Metropolitan Statistical Area)",2012,32974,97500,1764,99264,95736,8226669,249491,86,97,57.5,94.2,85.6
2794,23060,"Fort Wayne, IN (Metropolitan Statistical Area)",2012,38388,114300,1261,115561,113039,15133475,394225,91.1,97.7,71,94.4,90.7
2795,23420,"Fresno, CA (Metropolitan Statistical Area)",2012,34317,212100,2274,214374,209826,32431359,945045,98.2,96.9,95.7,101.3,97.8
2796,23460,"Gadsden, AL (Metropolitan Statistical Area)",2012,31572,101200,4223,105423,96977,3292259,104278,84.3,97.6,51,94.4,83.8
2797,23540,"Gainesville, FL (Metropolitan Statistical Area)",2012,35313,171200,2449,173649,168751,10884856,308240,96.2,97.4,97.1,94.3,95.7
2798,23580,"Gainesville, GA (Metropolitan Statistical Area)",2012,33450,169400,2675,172075,166725,6158237,184102,90.9,91.9,87.6,92.6,90.4
2799,23900,"Gettysburg, PA (Metropolitan Statistical Area)",2012,40010,204000,3826,207826,200174,4051220,101254,95.7,97.9,87.1,98,95.2
2800,24020,"Glens Falls, NY (Metropolitan Statistical Area)",2012,38570,166500,1849,168349,164651,4953204,128420,97.1,97.9,94,98,96.6
2801,24140,"Goldsboro, NC (Metropolitan Statistical Area)",2012,33971,108200,3759,111959,104441,4231418,124559,86.9,97.6,59.8,94.4,86.5
2802,24220,"Grand Forks, ND-MN (Metropolitan Statistical Area)",2012,44661,140400,2747,143147,137653,4425642,99093,92.7,97.7,80,94.4,92.3
2803,24260,"Grand Island, NE (Metropolitan Statistical Area)",2012,38396,108700,2486,111186,106214,2850457,74238,85,92.1,65.5,89.2,84.6
2804,24300,"Grand Junction, CO (Metropolitan Statistical Area)",2012,37105,216600,3612,220212,212988,5466236,147317,94.5,98.7,89.2,93.4,94.1
2805,24340,"Grand Rapids-Kentwood, MI (Metropolitan Statistical Area)",2012,41645,136400,1051,137451,135349,42214045,1013655,93.2,97,83.5,93.8,92.7
2806,24420,"Grants Pass, OR (Metropolitan Statistical Area)",2012,32295,231800,7053,238853,224747,2672588,82755,93.2,98.7,84.5,93.4,92.7
2807,24500,"Great Falls, MT (Metropolitan Statistical Area)",2012,40410,155100,2373,157473,152727,3298332,81622,94.5,96.9,77.9,101.3,94.1
2808,24540,"Greeley, CO (Metropolitan Statistical Area) *",2012,37088,192100,2658,194758,189442,9796051,264131,96.9,102,86.3,99.8,96.4
2809,24580,"Green Bay, WI (Metropolitan Statistical Area)",2012,43582,156900,1352,158252,155548,13536902,310605,92.3,97,79.6,93.7,91.8
2810,24660,"Greensboro-High Point, NC (Metropolitan Statistical Area)",2012,37126,140200,1286,141486,138914,27305455,735475,90.4,97.2,72.7,94.2,90
2811,24780,"Greenville, NC (Metropolitan Statistical Area)",2012,35655,127500,3842,131342,123658,6167597,172980,89.3,97.6,68.4,94.4,88.8
2812,24860,"Greenville-Anderson, SC (Metropolitan Statistical Area)",2012,36034,140600,1567,142167,139033,30300987,840903,90.4,97.4,72.3,94.3,89.9
2813,25060,"Gulfport-Biloxi, MS (Metropolitan Statistical Area)",2012,34152,140900,2751,143651,138149,13551437,396803,91,97.6,76.5,94.4,90.6
2814,25180,"Hagerstown-Martinsburg, MD-WV (Metropolitan Statistical Area)",2012,37537,193300,3129,196429,190171,10263735,273429,102.4,107.3,86,109.9,101.9
2815,25220,"Hammond, LA (Metropolitan Statistical Area)",2012,34901,136000,6410,142410,129590,4315346,123646,85.3,91.9,70.7,92.6,84.9
2816,25260,"Hanford-Corcoran, CA (Metropolitan Statistical Area)",2012,29299,192000,4787,196787,187213,4423871,150991,94.6,98.7,89.3,93.4,94.1
2817,25420,"Harrisburg-Carlisle, PA (Metropolitan Statistical Area)",2012,43858,169000,1219,170219,167781,24343714,555057,96.5,97.9,90.6,98,96
2818,25500,"Harrisonburg, VA (Metropolitan Statistical Area) *",2012,33190,201200,4263,205463,196937,4263250,128449,92.2,91.9,91.9,92.6,91.7
2819,25540,"Hartford-East Hartford-Middletown, CT (Metropolitan Statistical Area)",2012,54457,255400,1334,256734,254066,66182128,1215307,100.9,98.1,112.6,98.4,100.4
2820,25620,"Hattiesburg, MS (Metropolitan Statistical Area)",2012,33161,128900,4205,133105,124695,5504469,165994,84.5,91.9,69.1,92.6,84.1
2821,25860,"Hickory-Lenoir-Morganton, NC (Metropolitan Statistical Area)",2012,32495,119400,1564,120964,117836,11817436,363670,89,97.6,66.1,94.4,88.6
2822,25940,"Hilton Head Island-Bluffton, SC (Metropolitan Statistical Area)",2012,42151,252200,7009,259209,245191,8141241,193145,93.9,91.9,98,92.6,93.5
2823,25980,"Hinesville, GA (Metropolitan Statistical Area)",2012,29455,123100,4035,127135,119065,2368382,80406,92.1,91.9,91.8,92.6,91.6
2824,26140,"Homosassa Springs, FL (Metropolitan Statistical Area)",2012,32371,126000,3933,129933,122067,4505437,139180,90,91.9,85.6,92.6,89.6
2825,26300,"Hot Springs, AR (Metropolitan Statistical Area)",2012,34607,131500,4203,135703,127297,3356362,96986,85.4,91.9,70.6,92.6,85
2826,26380,"Houma-Thibodaux, LA (Metropolitan Statistical Area)",2012,41731,126100,3812,129912,122288,8716905,208885,92.2,97.6,77.9,94.4,91.8
2827,26420,"Houston-The Woodlands-Sugar Land, TX (Metropolitan Statistical Area)",2012,51979,141000,510,141510,140490,321412642,6183531,100.2,96.5,98.7,105.4,99.7
2828,26580,"Huntington-Ashland, WV-KY-OH (Metropolitan Statistical Area)",2012,34151,95400,1548,96948,93852,12669066,370972,86.8,97.4,57.5,94.3,86.4
2829,26620,"Huntsville, AL (Metropolitan Statistical Area)",2012,42618,157600,2155,159755,155445,18328124,430056,91.2,97.6,72.5,94.4,90.8
2830,26820,"Idaho Falls, ID (Metropolitan Statistical Area)",2012,35831,157900,2492,160392,155408,4878883,136165,90.4,98.7,72.6,93.4,90
2831,26900,"Indianapolis-Carmel-Anderson, IN (Metropolitan Statistical Area)",2012,45735,145300,725,146025,144575,88253549,1929678,93.8,97.6,84.8,94.3,93.3
2832,26980,"Iowa City, IA (Metropolitan Statistical Area)",2012,44457,171400,2849,174249,168551,7069000,159006,96,97.2,97.7,93.9,95.6
2833,27060,"Ithaca, NY (Metropolitan Statistical Area)",2012,37821,169300,3416,172716,165884,3885194,102726,104.1,97.9,130.4,98,103.6
2834,27100,"Jackson, MI (Metropolitan Statistical Area)",2012,32262,116800,2484,119284,114316,5160689,159962,91.1,97.7,73.3,94.4,90.7
2835,27140,"Jackson, MS (Metropolitan Statistical Area)",2012,39026,131900,2342,134242,129558,23243557,595585,90.7,97.2,73.8,94.3,90.3
2836,27180,"Jackson, TN (Metropolitan Statistical Area)",2012,35250,111500,2980,114480,108520,6339970,179857,83.3,91.9,60.5,92.7,82.9
2837,27260,"Jacksonville, FL (Metropolitan Statistical Area)",2012,41611,172400,1196,173596,171204,57323751,1377607,96.4,97.6,97.6,94.3,95.9
2838,27340,"Jacksonville, NC (Metropolitan Statistical Area)",2012,42910,149900,2864,152764,147036,8181946,190678,96,97.6,95.7,94.4,95.5
2839,27500,"Janesville-Beloit, WI (Metropolitan Statistical Area)",2012,37474,136700,1776,138476,134924,5998210,160065,93,97.7,80.6,94.4,92.5
2840,27620,"Jefferson City, MO (Metropolitan Statistical Area)",2012,37039,135700,2555,138255,133145,5570268,150391,82,92.1,59.5,89.2,81.6
2841,27740,"Johnson City, TN (Metropolitan Statistical Area)",2012,34653,127200,3374,130574,123826,6946931,200473,88.4,97.6,63.9,94.4,88
2842,27780,"Johnstown, PA (Metropolitan Statistical Area)",2012,36003,87300,1463,88763,85837,5095726,141536,87.1,97.9,53.5,98,86.7
2843,27860,"Jonesboro, AR (Metropolitan Statistical Area)",2012,32720,101600,4061,105661,97539,4066788,124292,81.9,91.9,60.6,92.6,81.5
2844,27900,"Joplin, MO (Metropolitan Statistical Area)",2012,34597,99400,2027,101427,97373,6034019,174407,88.1,97.7,60.5,94.4,87.6
2845,27980,"Kahului-Wailuku-Lahaina, HI (Metropolitan Statistical Area)",2012,39682,563500,11849,575349,551651,6308599,158978,107.4,98.7,152.5,93.4,106.9
2846,28020,"Kalamazoo-Portage, MI (Metropolitan Statistical Area)",2012,39660,137100,1652,138752,135448,10127288,255353,92.8,97.7,80.1,94.4,92.3
2847,28100,"Kankakee, IL (Metropolitan Statistical Area)",2012,34334,149200,2779,151979,146421,3878796,112974,98.8,103.5,82.4,104.1,98.3
2848,28140,"Kansas City, MO-KS (Metropolitan Statistical Area)",2012,45721,158800,641,159441,158159,93205450,2038586,93.8,96.3,84.5,95.1,93.3
2849,28420,"Kennewick-Richland, WA (Metropolitan Statistical Area)",2012,38308,169800,1630,171430,168170,10269252,268071,97.8,96.9,92.6,101.3,97.3
2850,28660,"Killeen-Temple, TX (Metropolitan Statistical Area)",2012,38140,116700,1756,118456,114944,16151189,423475,92.7,97.4,82.6,94.3,92.2
2851,28700,"Kingsport-Bristol, TN-VA (Metropolitan Statistical Area) *",2012,36315,115400,1835,117235,113565,11207746,308623,86.3,97.6,57.3,94.4,85.9
2852,28740,"Kingston, NY (Metropolitan Statistical Area)",2012,40964,237500,3376,240876,234124,7436442,181538,102.4,97.9,122.3,98,102
2853,28940,"Knoxville, TN (Metropolitan Statistical Area)",2012,38555,154700,1339,156039,153361,31807934,825007,90.4,97,73,94.2,90
2854,29020,"Kokomo, IN (Metropolitan Statistical Area)",2012,34578,102200,2625,104825,99575,2864369,82839,88.4,97.7,63,94.4,87.9
2855,29100,"La Crosse-Onalaska, WI-MN (Metropolitan Statistical Area)",2012,42106,153200,2056,155256,151144,5697211,135307,93.7,97.7,84.1,94.4,93.3
2856,29180,"Lafayette, LA (Metropolitan Statistical Area)",2012,43624,147600,3028,150628,144572,20686851,474205,88.4,96.6,66.4,94.1,88
2857,29340,"Lake Charles, LA (Metropolitan Statistical Area)",2012,38060,117700,3004,120704,114696,7654187,201110,88.6,97.5,64.8,94.3,88.2
2858,29420,"Lake Havasu City-Kingman, AZ (Metropolitan Statistical Area)",2012,26012,144700,3976,148676,140724,5289425,203347,94.5,96.9,79.4,101.3,94
2859,29460,"Lakeland-Winter Haven, FL (Metropolitan Statistical Area)",2012,31791,120200,1744,121944,118456,19565614,615453,94,97.6,87.4,94.4,93.5
2860,29540,"Lancaster, PA (Metropolitan Statistical Area)",2012,41080,189600,1545,191145,188055,21644309,526878,98.4,97.9,100.4,98,97.9
2861,29620,"Lansing-East Lansing, MI (Metropolitan Statistical Area)",2012,34511,137900,1596,139496,136304,18532389,537005,94.5,97.7,88.3,94.4,94.1
2862,29700,"Laredo, TX (Metropolitan Statistical Area)",2012,28425,107700,2271,109971,105429,7407303,260595,89,97.6,69,94.4,88.5
2863,29740,"Las Cruces, NM (Metropolitan Statistical Area)",2012,31304,142700,3903,146603,138797,6713247,214450,93.1,96.9,73.6,101.3,92.6
2864,29820,"Las Vegas-Henderson-Paradise, NV (Metropolitan Statistical Area)",2012,38921,186700,1742,188442,184958,77423058,1989224,100.1,96.9,104.9,101.3,99.6
2865,29940,"Lawrence, KS (Metropolitan Statistical Area)",2012,36145,178700,4564,183264,174136,4095673,113313,95.7,97.7,93.9,94.4,95.2
2866,30020,"Lawton, OK (Metropolitan Statistical Area)",2012,36453,110900,2661,113561,108239,4837175,132696,91,97,74.3,94.3,90.6
2867,30140,"Lebanon, PA (Metropolitan Statistical Area)",2012,39019,164100,2112,166212,161988,5288885,135545,94.7,97.9,82.9,98,94.3
2868,30300,"Lewiston, ID-WA (Metropolitan Statistical Area)",2012,37054,169400,3457,172857,165943,2275589,61413,90.7,98.7,73.4,93.4,90.2
2869,30340,"Lewiston-Auburn, ME (Metropolitan Statistical Area)",2012,35614,156700,2656,159356,154044,3827984,107486,94.8,97.9,84.3,98,94.3
2870,30460,"Lexington-Fayette, KY (Metropolitan Statistical Area)",2012,40154,160600,1663,162263,158937,19483974,485236,92.2,97.6,77.9,94.4,91.8
2871,30620,"Lima, OH (Metropolitan Statistical Area)",2012,35575,104400,2501,106901,101899,3744061,105244,88.9,97.7,63.4,94.4,88.5
2872,30700,"Lincoln, NE (Metropolitan Statistical Area)",2012,42386,147200,1289,148489,145911,13153624,310328,93.1,97.5,81.8,94.2,92.6
2873,30780,"Little Rock-North Little Rock-Conway, AR (Metropolitan Statistical Area)",2012,40456,134100,1503,135603,132597,29033933,717665,91.1,97.5,74.1,94.3,90.7
2874,30860,"Logan, UT-ID (Metropolitan Statistical Area)",2012,31017,187400,2682,190082,184718,3991670,128693,89.8,98.7,70.5,93.4,89.4
2875,30980,"Longview, TX (Metropolitan Statistical Area)",2012,40197,103900,2312,106212,101588,11377930,283056,91.8,96.7,78.9,94.1,91.4
2876,31020,"Longview, WA (Metropolitan Statistical Area)",2012,37764,189900,3979,193879,185921,3839243,101663,93.3,98.7,84.1,93.4,92.8
2877,31140,"Louisville/Jefferson County, KY-IN (Metropolitan Statistical Area)",2012,42129,146900,841,147741,146059,51405485,1220183,91.1,97.3,74.1,94.2,90.6
2878,31180,"Lubbock, TX (Metropolitan Statistical Area)",2012,36391,105900,1815,107715,104085,10836972,297793,93.6,97.3,85.2,94.3,93.1
2879,31340,"Lynchburg, VA (Metropolitan Statistical Area) *",2012,35357,158900,2340,161240,156560,9041666,255725,90.2,97.4,71.9,94.3,89.8
2880,31420,"Macon-Bibb County, GA (Metropolitan Statistical Area)",2012,34156,122400,2786,125186,119614,7949324,232734,87.9,96.9,64.7,94.2,87.4
2881,31460,"Madera, CA (Metropolitan Statistical Area)",2012,31712,210300,7034,217334,203266,4805261,151527,96.9,96.9,89.7,101.3,96.5
2882,31540,"Madison, WI (Metropolitan Statistical Area)",2012,48026,223300,1271,224571,222029,29762659,619719,97.6,97,107.2,93.8,97.2
2883,31700,"Manchester-Nashua, NH (Metropolitan Statistical Area)",2012,52183,258000,2016,260016,255984,21100002,404344,108.3,100.3,125.7,107.9,107.7
2884,31740,"Manhattan, KS (Metropolitan Statistical Area)",2012,40458,153900,3471,157371,150429,5572294,137731,93.6,92.1,101.7,89.2,93.1
2885,31860,"Mankato, MN (Metropolitan Statistical Area)",2012,40176,164800,2008,166808,162792,3937031,97994,89.5,92.1,86.1,89.2,89
2886,31900,"Mansfield, OH (Metropolitan Statistical Area)",2012,32895,107000,2264,109264,104736,4033984,122633,88.5,97.7,62.6,94.4,88
2887,32580,"McAllen-Edinburg-Mission, TX (Metropolitan Statistical Area)",2012,23130,76900,1219,78119,75681,18696793,808334,84.9,97.6,55.8,94.4,84.5
2888,32780,"Medford, OR (Metropolitan Statistical Area)",2012,36135,242300,4354,246654,237946,7438436,205852,98.6,96.9,97.5,101.3,98.1
2889,32820,"Memphis, TN-MS-AR (Metropolitan Statistical Area)",2012,40331,136800,1431,138231,135369,53696436,1331396,92.2,97.4,79.2,94.3,91.7
2890,32900,"Merced, CA (Metropolitan Statistical Area)",2012,31092,161600,3724,165324,157876,8110944,260867,96.4,96.9,87.3,101.3,96
2891,33100,"Miami-Fort Lauderdale-Pompano Beach, FL (Metropolitan Statistical Area)",2012,46027,213000,1107,214107,211893,264462149,5745743,105.3,100,128.8,98.4,104.8
2892,33140,"Michigan City-La Porte, IN (Metropolitan Statistical Area)",2012,35975,120600,2393,122993,118207,4004198,111304,85.7,92.1,72.8,89.2,85.3
2893,33220,"Midland, MI (Metropolitan Statistical Area)",2012,45267,130200,3147,133347,127053,3789807,83721,93.1,97.7,80.5,94.4,92.6
2894,33260,"Midland, TX (Metropolitan Statistical Area)",2012,106681,141100,4226,145326,136874,16248753,152312,97.5,97.3,106.6,94.3,97.1
2895,33340,"Milwaukee-Waukesha, WI (Metropolitan Statistical Area)",2012,48084,202800,1091,203891,201709,75359894,1567248,96.1,95.3,98.3,96,95.6
2896,33460,"Minneapolis-St. Paul-Bloomington, MN-WI (Metropolitan Statistical Area)",2012,51623,226200,672,226872,225528,175824856,3405952,102.5,103,110.1,98.5,102
2897,33540,"Missoula, MT (Metropolitan Statistical Area)",2012,38783,238100,4430,242530,233670,4306521,111042,95.8,98.7,94.2,93.4,95.3
2898,33660,"Mobile, AL (Metropolitan Statistical Area)",2012,33464,125400,1735,127135,123665,14421637,430962,88.2,97.6,64.6,94.4,87.8
2899,33700,"Modesto, CA (Metropolitan Statistical Area)",2012,34624,192200,2861,195061,189339,18018958,520424,99.6,96.9,102.8,101.3,99.2
2900,33740,"Monroe, LA (Metropolitan Statistical Area)",2012,34729,112200,3813,116013,108387,7124674,205151,86.8,97.2,58.6,94.2,86.4
2901,33780,"Monroe, MI (Metropolitan Statistical Area)",2012,37507,147600,2981,150581,144619,5656186,150804,96,99.1,81.8,100,95.6
2902,33860,"Montgomery, AL (Metropolitan Statistical Area)",2012,36640,128800,2191,130991,126609,13735181,374872,90,97.5,70.6,94.3,89.5
2903,34060,"Morgantown, WV (Metropolitan Statistical Area)",2012,36393,136400,5459,141859,130941,4906297,134813,88.5,91.9,79.3,92.6,88.1
2904,34100,"Morristown, TN (Metropolitan Statistical Area)",2012,30432,116300,2941,119241,113359,4192168,137753,82.8,91.9,64,92.6,82.4
2905,34580,"Mount Vernon-Anacortes, WA (Metropolitan Statistical Area)",2012,42096,271000,3994,274994,267006,4955299,117714,98,98.7,104.3,93.4,97.5
2906,34620,"Muncie, IN (Metropolitan Statistical Area)",2012,31101,90800,1719,92519,89081,3639667,117027,90,97.7,70.8,94.4,89.6
2907,34740,"Muskegon, MI (Metropolitan Statistical Area)",2012,31737,105700,1824,107524,103876,5400288,170159,89.6,97.7,67.5,94.4,89.2
2908,34820,"Myrtle Beach-Conway-North Myrtle Beach, SC-NC (Metropolitan Statistical Area)",2012,31625,164000,2382,166382,161618,12438165,393299,92.5,96.3,87.3,94,92.1
2909,34900,"Napa, CA (Metropolitan Statistical Area)",2012,53739,460400,11291,471691,449109,7444938,138538,118.6,108.6,155.5,109.5,118
2910,34940,"Naples-Marco Island, FL (Metropolitan Statistical Area)",2012,71923,280700,5801,286501,274899,23895153,332233,98.9,97.6,112.3,94.4,98.4
2911,34980,"Nashville-Davidson--Murfreesboro--Franklin, TN (Metropolitan Statistical Area)",2012,46437,173700,787,174487,172913,79110918,1703609,93.8,97.3,86.3,94.3,93.3
2912,35100,"New Bern, NC (Metropolitan Statistical Area)",2012,37945,148400,5276,153676,143124,4872465,128409,87,91.9,76.5,92.6,86.5
2913,35300,"New Haven-Milford, CT (Metropolitan Statistical Area)",2012,48089,263900,1749,265649,262151,41576477,864566,113.2,108.2,117.5,116.1,112.7
2914,35380,"New Orleans-Metairie, LA (Metropolitan Statistical Area)",2012,45127,178000,1319,179319,176681,55365993,1226887,96.5,97.4,98.8,94.3,96.1
2915,35620,"New York-Newark-Jersey City, NY-NJ-PA (Metropolitan Statistical Area)",2012,60160,427500,763,428263,426737,1152045984,19149689,122.4,109.4,157,118.6,121.8
2916,35660,"Niles, MI (Metropolitan Statistical Area)",2012,37779,135100,2760,137860,132340,5916924,156621,89.9,97.7,68.8,94.4,89.5
2917,35840,"North Port-Sarasota-Bradenton, FL (Metropolitan Statistical Area)",2012,44335,184300,1995,186295,182305,31933841,720281,98.8,97.6,109.1,94.4,98.3
2918,35980,"Norwich-New London, CT (Metropolitan Statistical Area)",2012,49424,260600,3314,263914,257286,13546583,274091,101.3,97.9,115.3,98,100.8
2919,36100,"Ocala, FL (Metropolitan Statistical Area)",2012,31799,130900,2707,133607,128193,10616930,333873,92,97.6,79.8,94.4,91.5
2920,36140,"Ocean City, NJ (Metropolitan Statistical Area)",2012,48772,326400,5116,331516,321284,4693248,96228,108.3,102.9,116.4,108.7,107.8
2921,36220,"Odessa, TX (Metropolitan Statistical Area)",2012,44675,88300,2609,90909,85691,6455247,144495,93.4,97.6,82.9,94.4,93
2922,36260,"Ogden-Clearfield, UT (Metropolitan Statistical Area)",2012,35499,204500,1738,206238,202762,21732032,612185,96.4,97.1,86.8,100.8,95.9
2923,36420,"Oklahoma City, OK (Metropolitan Statistical Area)",2012,42418,128000,956,128956,127044,55052398,1297857,92.3,97.4,78.9,94.3,91.9
2924,36500,"Olympia-Lacey-Tumwater, WA (Metropolitan Statistical Area)",2012,42403,251000,2977,253977,248023,10962313,258527,104.6,105.6,109.7,101.3,104.1
2925,36540,"Omaha-Council Bluffs, NE-IA (Metropolitan Statistical Area)",2012,50406,145400,674,146074,144726,44587051,884555,94.4,97.5,88,94.2,94
2926,36740,"Orlando-Kissimmee-Sanford, FL (Metropolitan Statistical Area)",2012,35315,176200,1408,177608,174792,78597650,2225636,98,97.6,104.9,94.4,97.6
2927,36780,"Oshkosh-Neenah, WI (Metropolitan Statistical Area)",2012,40287,141100,2038,143138,139062,6789412,168525,92.8,97.7,79.4,94.4,92.3
2928,36980,"Owensboro, KY (Metropolitan Statistical Area)",2012,36473,104000,2543,106543,101457,4229886,115972,86.7,97,59.8,94.2,86.3
2929,37100,"Oxnard-Thousand Oaks-Ventura, CA (Metropolitan Statistical Area)",2012,50010,465600,3484,469084,462116,41683974,833516,115.3,100.2,169.9,103.1,114.7
2930,37340,"Palm Bay-Melbourne-Titusville, FL (Metropolitan Statistical Area)",2012,38092,157200,1626,158826,155574,20834899,546966,95.7,97.6,94.7,94.4,95.3
2931,37460,"Panama City, FL (Metropolitan Statistical Area)",2012,37476,163000,3029,166029,159971,6436815,171757,95.7,96.8,96,94.2,95.2
2932,37620,"Parkersburg-Vienna, WV (Metropolitan Statistical Area)",2012,35618,104500,2150,106650,102350,3290704,92390,86.5,97.4,56.5,94.3,86.1
2933,37860,"Pensacola-Ferry Pass-Brent, FL (Metropolitan Statistical Area)",2012,37079,148500,2463,150963,146037,17116015,461613,94.5,97.6,89.4,94.4,94.1
2934,37900,"Peoria, IL (Metropolitan Statistical Area)",2012,44026,128300,1660,129960,126640,18352740,416866,91.3,97.5,72.4,94.2,90.9
2935,37980,"Philadelphia-Camden-Wilmington, PA-NJ-DE-MD (Metropolitan Statistical Area)",2012,53149,244100,665,244765,243435,319777942,6016616,107.4,102.9,113.5,108.7,106.9
2936,38060,"Phoenix-Mesa-Chandler, AZ (Metropolitan Statistical Area)",2012,37867,185600,1120,186720,184480,163954845,4329756,98.1,98.6,99.3,97,97.7
2937,38220,"Pine Bluff, AR (Metropolitan Statistical Area)",2012,29970,78200,2571,80771,75629,2919796,97423,85.1,96.8,53.7,94.1,84.6
2938,38300,"Pittsburgh, PA (Metropolitan Statistical Area)",2012,46792,122800,598,123398,122202,110449274,2360443,94.5,97.5,77.9,99.3,94.1
2939,38340,"Pittsfield, MA (Metropolitan Statistical Area)",2012,45210,209200,5331,214531,203869,5890154,130284,96.4,97.9,90.8,98,95.9
2940,38540,"Pocatello, ID (Metropolitan Statistical Area)",2012,31319,143500,2631,146131,140869,2868384,91585,89.8,98.7,71.2,93.4,89.4
2941,38860,"Portland-South Portland, ME (Metropolitan Statistical Area)",2012,46456,235800,1677,237477,234123,24047186,517632,100.5,98.1,108.8,98.8,100
2942,38900,"Portland-Vancouver-Hillsboro, OR-WA (Metropolitan Statistical Area)",2012,44391,276300,1019,277319,275281,101586721,2288465,100.7,98.6,109.3,99.7,100.2
2943,38940,"Port St. Lucie, FL (Metropolitan Statistical Area)",2012,44573,156400,2193,158593,154207,19251545,431912,95.9,97.6,95.5,94.4,95.5
2944,39100,"Poughkeepsie-Newburgh-Middletown, NY (Metropolitan Statistical Area)",2012,44406,293800,1958,295758,291842,29784003,670722,(NA),(NA),(NA),(NA),(NA)
2945,39300,"Providence-Warwick, RI-MA (Metropolitan Statistical Area)",2012,45449,270300,1170,271470,269130,72979746,1605741,99.6,98.4,101.6,99.9,99.2
2946,39340,"Provo-Orem, UT (Metropolitan Statistical Area)",2012,29983,227500,1861,229361,225639,16490032,549980,97.6,97,92.4,101.2,97.1
2947,39380,"Pueblo, CO (Metropolitan Statistical Area)",2012,31672,140500,2602,143102,137898,5090276,160721,93.2,96.9,74,101.3,92.7
2948,39460,"Punta Gorda, FL (Metropolitan Statistical Area)",2012,34178,154300,3158,157458,151142,5562222,162744,95.4,97.6,93.4,94.4,95
2949,39540,"Racine, WI (Metropolitan Statistical Area)",2012,41807,174600,2553,177153,172047,8135331,194594,94.2,95.3,87.7,96,93.7
2950,39580,"Raleigh-Cary, NC (Metropolitan Statistical Area)",2012,45749,205500,2161,207661,203339,54343403,1187848,95.3,97.6,92.2,94.4,94.9
2951,39660,"Rapid City, SD (Metropolitan Statistical Area)",2012,42970,157000,2401,159401,154599,5589367,130075,92.3,96.3,82.6,93.2,91.8
2952,39740,"Reading, PA (Metropolitan Statistical Area)",2012,41624,173400,1455,174855,171945,17212314,413518,96.6,97.9,91.8,98,96.2
2953,39820,"Redding, CA (Metropolitan Statistical Area)",2012,36380,233400,4530,237930,228870,6471067,177875,99.2,96.9,100.3,101.3,98.7
2954,39900,"Reno, NV (Metropolitan Statistical Area)",2012,43597,226300,3157,229457,223143,18799486,431208,100.1,97,105.4,101.3,99.6
2955,40060,"Richmond, VA (Metropolitan Statistical Area) *",2012,47818,224200,1125,225325,223075,57908229,1211015,96.5,97.4,98.6,94.3,96
2956,40140,"Riverside-San Bernardino-Ontario, CA (Metropolitan Statistical Area)",2012,32268,245300,1349,246649,243951,139872107,4334716,107,100.2,122.9,103.1,106.5
2957,40220,"Roanoke, VA (Metropolitan Statistical Area) *",2012,41399,170600,1759,172359,168841,12853437,310479,91.2,96.9,76.5,94.2,90.7
2958,40340,"Rochester, MN (Metropolitan Statistical Area)",2012,46219,169800,1544,171344,168256,9685088,209547,92.9,96.3,84.4,93.1,92.5
2959,40380,"Rochester, NY (Metropolitan Statistical Area)",2012,43443,128200,871,129071,127329,46983784,1081508,97.5,97.9,95.6,97.9,97
2960,40420,"Rockford, IL (Metropolitan Statistical Area)",2012,36386,132600,1354,133954,131246,12582901,345819,91.9,97.7,76.7,94.4,91.4
2961,40580,"Rocky Mount, NC (Metropolitan Statistical Area)",2012,34103,100100,2935,103035,97165,5144857,150862,86.7,97.6,57.8,94.4,86.3
2962,40660,"Rome, GA (Metropolitan Statistical Area)",2012,31938,115000,4200,119200,110800,3064146,95940,82.3,91.9,62.5,92.6,81.9
2963,40900,"Sacramento-Roseville-Folsom, CA (Metropolitan Statistical Area)",2012,44631,287800,1391,289191,286409,97754276,2190266,103,96.9,122.5,101.3,102.5
2964,40980,"Saginaw, MI (Metropolitan Statistical Area)",2012,32358,101600,2075,103675,99525,6418545,198363,89.7,97.7,67,94.4,89.3
2965,41060,"St. Cloud, MN (Metropolitan Statistical Area)",2012,38722,167200,1595,168795,165605,7379013,190562,93.3,97.7,82.9,94.4,92.8
2966,41100,"St. George, UT (Metropolitan Statistical Area)",2012,27992,223100,3649,226749,219451,4034723,144139,94.3,98.7,88.9,93.4,93.9
2967,41140,"St. Joseph, MO-KS (Metropolitan Statistical Area)",2012,34230,110600,2546,113146,108054,4378285,127908,88.1,97.1,63,93.8,87.7
2968,41180,"St. Louis, MO-IL (Metropolitan Statistical Area)",2012,46679,159700,708,160408,158992,130546919,2796682,90.6,94.1,83.6,90.5,90.2
2969,41420,"Salem, OR (Metropolitan Statistical Area)",2012,33301,206600,2308,208908,204292,13189643,396076,97,98.6,87.9,99.7,96.5
2970,41500,"Salinas, CA (Metropolitan Statistical Area)",2012,43930,390400,7396,397796,383004,18661045,424788,107.7,96.9,153.7,101.3,107.2
2971,41540,"Salisbury, MD-DE (Metropolitan Statistical Area)",2012,39383,183400,4442,187842,178958,15013376,381216,89.8,91.9,84.6,92.6,89.4
2972,41620,"Salt Lake City, UT (Metropolitan Statistical Area)",2012,40607,237400,1319,238719,236081,45632457,1123748,99.5,97,102.9,101.1,99
2973,41660,"San Angelo, TX (Metropolitan Statistical Area)",2012,40513,95800,3157,98957,92643,4702390,116071,91.9,97.6,77.4,94.3,91.5
2974,41700,"San Antonio-New Braunfels, TX (Metropolitan Statistical Area)",2012,39132,129600,992,130592,128608,87538545,2236981,94,97.3,87.1,94.3,93.5
2975,41740,"San Diego-Chula Vista-Carlsbad, CA (Metropolitan Statistical Area)",2012,48315,419400,2531,421931,416869,153367801,3174335,118.3,102.1,165.7,105.4,117.7
2976,41860,"San Francisco-Oakland-Berkeley, CA (Metropolitan Statistical Area)",2012,70428,595400,2123,597523,593277,313789675,4455473,121.4,108.6,182.1,109.5,120.8
2977,41940,"San Jose-Sunnyvale-Santa Clara, CA (Metropolitan Statistical Area)",2012,71791,648600,3179,651779,645421,136004062,1894452,122.3,108.4,191.2,109.2,121.7
2978,42020,"San Luis Obispo-Paso Robles, CA (Metropolitan Statistical Area)",2012,44674,449300,8044,457344,441256,12247840,274160,107.3,96.9,150.4,101.3,106.7
2979,42100,"Santa Cruz-Watsonville, CA (Metropolitan Statistical Area)",2012,53185,576500,8510,585010,567990,14165234,266340,121.6,108.6,170.4,109.5,121
2980,42140,"Santa Fe, NM (Metropolitan Statistical Area)",2012,47220,288200,5012,293212,283188,6928267,146722,99.8,96.9,103.9,101.3,99.3
2981,42220,"Santa Rosa-Petaluma, CA (Metropolitan Statistical Area)",2012,46922,430900,4487,435387,426413,22991360,489993,118.4,108.6,152.1,109.5,117.9
2982,42340,"Savannah, GA (Metropolitan Statistical Area)",2012,39598,173000,1877,174877,171123,14324203,361745,95.1,97.6,91.6,94.4,94.6
2983,42540,"Scranton--Wilkes-Barre, PA (Metropolitan Statistical Area)",2012,38678,129400,1666,131066,127734,21802967,563704,91.9,97.9,71.5,98,91.5
2984,42660,"Seattle-Tacoma-Bellevue, WA (Metropolitan Statistical Area)",2012,55742,336900,1160,338060,335740,198375359,3558829,107.4,105.6,128,101.3,106.9
2985,42680,"Sebastian-Vero Beach, FL (Metropolitan Statistical Area)",2012,60869,165500,2985,168485,162515,8550399,140473,91.9,91.9,91,92.6,91.4
2986,42700,"Sebring-Avon Park, FL (Metropolitan Statistical Area)",2012,29913,104800,3675,108475,101125,2938159,98222,87.1,91.9,77.4,92.6,86.7
2987,43100,"Sheboygan, WI (Metropolitan Statistical Area)",2012,44078,153800,2239,156039,151561,5058669,114767,91,97.7,72.3,94.4,90.6
2988,43300,"Sherman-Denison, TX (Metropolitan Statistical Area)",2012,35621,103200,3440,106640,99760,4340610,121854,91.5,97.6,75.2,94.4,91.1
2989,43340,"Shreveport-Bossier City, LA (Metropolitan Statistical Area)",2012,40927,124800,2696,127496,122104,16675025,407435,90.6,97.4,72.2,94.3,90.2
2990,43420,"Sierra Vista-Douglas, AZ (Metropolitan Statistical Area)",2012,34354,151800,4418,156218,147382,4535292,132017,92.8,98.7,82.3,93.4,92.3
2991,43580,"Sioux City, IA-NE-SD (Metropolitan Statistical Area)",2012,41631,99100,1601,100701,97499,5983349,143723,89.6,95.6,69.5,92.6,89.2
2992,43620,"Sioux Falls, SD (Metropolitan Statistical Area)",2012,49589,152500,1558,154058,150942,11754266,237032,93.5,97.5,82.9,94.2,93
2993,43780,"South Bend-Mishawaka, IN-MI (Metropolitan Statistical Area)",2012,38060,119400,1311,120711,118089,12114468,318296,91.3,97.1,76,93.8,90.8
2994,43900,"Spartanburg, SC (Metropolitan Statistical Area)",2012,36138,119600,2222,121822,117378,10414088,288176,87.7,97.3,63.6,94.3,87.3
2995,44060,"Spokane-Spokane Valley, WA (Metropolitan Statistical Area)",2012,37468,190300,1785,192085,188515,19443449,518930,96,97.1,85.7,100.1,95.6
2996,44100,"Springfield, IL (Metropolitan Statistical Area)",2012,40756,123700,1846,125546,121854,8644092,212095,92.4,97.7,74.9,94.4,91.9
2997,44140,"Springfield, MA (Metropolitan Statistical Area)",2012,43236,219000,1316,220316,217684,30224716,699061,96.6,97.9,92,98,96.1
2998,44180,"Springfield, MO (Metropolitan Statistical Area)",2012,34467,129400,1842,131242,127558,15314624,444329,89.4,97.3,69,94.1,89
2999,44220,"Springfield, OH (Metropolitan Statistical Area)",2012,34531,108100,1931,110031,106169,4736679,137171,89.5,97.7,66,94.4,89.1
3000,44300,"State College, PA (Metropolitan Statistical Area)",2012,38635,189800,4004,193804,185796,6020263,155826,102.2,97.9,119.1,98,101.7
3001,44420,"Staunton, VA (Metropolitan Statistical Area) *",2012,37530,186100,3973,190073,182127,4445967,118463,87.8,91.9,78.1,92.6,87.4
3002,44700,"Stockton, CA (Metropolitan Statistical Area)",2012,34403,225400,3057,228457,222343,24068159,699593,101.2,96.9,111.2,101.3,100.7
3003,44940,"Sumter, SC (Metropolitan Statistical Area)",2012,31951,105400,3925,109325,101475,4541032,142126,88.7,97.6,67.4,94.4,88.3
3004,45060,"Syracuse, NY (Metropolitan Statistical Area)",2012,41091,121900,979,122879,120921,27157220,660902,95.7,97.9,87.5,98,95.3
3005,45220,"Tallahassee, FL (Metropolitan Statistical Area)",2012,35779,170500,1995,172495,168505,13426939,375272,95.2,97.2,93.3,94.2,94.8
3006,45300,"Tampa-St. Petersburg-Clearwater, FL (Metropolitan Statistical Area)",2012,40144,157600,811,158411,156789,114155124,2843636,100.5,97.9,105.3,100.6,100
3007,45460,"Terre Haute, IN (Metropolitan Statistical Area)",2012,32478,86800,1324,88124,85476,6156378,189555,88.1,97.2,62.3,93.9,87.6
3008,45500,"Texarkana, TX-AR (Metropolitan Statistical Area)",2012,33803,91600,2639,94239,88961,5057197,149609,89,96.6,65.1,94.2,88.6
3009,45540,"The Villages, FL (Metropolitan Statistical Area)",2012,36564,187600,4086,191686,183514,3717455,101669,83.7,91.9,72.9,92.6,83.3
3010,45780,"Toledo, OH (Metropolitan Statistical Area)",2012,38651,124100,1136,125236,122964,25074981,648750,90.3,97.7,69.5,94.4,89.9
3011,45820,"Topeka, KS (Metropolitan Statistical Area)",2012,39042,118100,1519,119619,116581,9151617,234407,89.9,96.8,70.4,93.5,89.4
3012,45940,"Trenton-Princeton, NJ (Metropolitan Statistical Area)",2012,59268,293100,3509,296609,289591,21843573,368554,112.3,101.8,123.7,117.3,111.8
3013,46060,"Tucson, AZ (Metropolitan Statistical Area)",2012,36380,177500,1620,179120,175880,36127005,993052,97.7,96.9,92.8,101.3,97.2
3014,46140,"Tulsa, OK (Metropolitan Statistical Area)",2012,50943,127100,1064,128164,126036,48522625,952484,91.1,97.4,73.4,94.3,90.6
3015,46220,"Tuscaloosa, AL (Metropolitan Statistical Area)",2012,33487,144400,3393,147793,141007,8114915,242328,88.3,96.6,65.2,94.2,87.9
3016,46300,"Twin Falls, ID (Metropolitan Statistical Area)",2012,32917,148100,3190,151290,144910,3328850,101128,(NA),(NA),(NA),(NA),(NA)
3017,46340,"Tyler, TX (Metropolitan Statistical Area)",2012,47625,119300,2686,121986,116614,10230451,214811,94.6,97.6,89,94.4,94.2
3018,46540,"Utica-Rome, NY (Metropolitan Statistical Area)",2012,37417,104300,1537,105837,102763,11149874,297992,92.7,97.9,74.7,98,92.3
3019,46660,"Valdosta, GA (Metropolitan Statistical Area)",2012,29835,127900,3644,131544,124256,4299896,144121,84,91.9,68.5,92.6,83.6
3020,46700,"Vallejo, CA (Metropolitan Statistical Area)",2012,39562,290500,4504,295004,285996,16603091,419674,116.4,108.6,140.4,109.5,115.8
3021,47020,"Victoria, TX (Metropolitan Statistical Area)",2012,41861,103700,3650,107350,100050,4037391,96447,91.6,97.3,76,94.3,91.1
3022,47220,"Vineland-Bridgeton, NJ (Metropolitan Statistical Area)",2012,34182,174400,2775,177175,171625,5364308,156934,103.1,102.9,94.6,108.7,102.6
3023,47260,"Virginia Beach-Norfolk-Newport News, VA-NC (Metropolitan Statistical Area) *",2012,43445,245200,1225,246425,243975,75338951,1734121,99.3,97.5,111.7,94.3,98.8
3024,47300,"Visalia, CA (Metropolitan Statistical Area)",2012,32300,172100,1465,173565,170635,14527927,449779,96.2,96.9,85.7,101.3,95.7
3025,47380,"Waco, TX (Metropolitan Statistical Area)",2012,33607,106600,2284,108884,104316,8635042,256938,91.4,97,75.8,94.2,90.9
3026,47460,"Walla Walla, WA (Metropolitan Statistical Area)",2012,37530,206300,5528,211828,200772,2226635,59329,92.7,98.6,80.9,93.4,92.3
3027,47580,"Warner Robins, GA (Metropolitan Statistical Area)",2012,35984,135800,3313,139113,132487,6246620,173592,89,97,67.4,94.3,88.5
3028,47900,"Washington-Arlington-Alexandria, DC-VA-MD-WV (Metropolitan Statistical Area) *",2012,62906,384000,1269,385269,382731,369822854,5878942,119.5,107.2,168.9,109.9,118.9
3029,47940,"Waterloo-Cedar Falls, IA (Metropolitan Statistical Area)",2012,40363,124300,1991,126291,122309,6813789,168811,91.5,96.7,77.7,93.4,91.1
3030,48060,"Watertown-Fort Drum, NY (Metropolitan Statistical Area)",2012,42310,129000,3643,132643,125357,5087170,120235,98.5,97.9,100.5,98,98
3031,48140,"Wausau-Weston, WI (Metropolitan Statistical Area)",2012,40872,142600,1900,144500,140700,6656815,162870,92.5,97.7,76.6,94.4,92.1
3032,48300,"Wenatchee, WA (Metropolitan Statistical Area)",2012,38637,242700,6276,248976,236424,4353233,112669,95.6,98.7,93.3,93.4,95.1
3033,48540,"Wheeling, WV-OH (Metropolitan Statistical Area)",2012,36116,88800,1767,90567,87033,5292016,146527,86,97.6,53.1,94.4,85.6
3034,48620,"Wichita, KS (Metropolitan Statistical Area)",2012,45727,120400,1176,121576,119224,28724024,628159,91.2,97.4,72.6,94.2,90.7
3035,48660,"Wichita Falls, TX (Metropolitan Statistical Area)",2012,42258,88700,1895,90595,86805,6382645,151040,91,97.3,75,94.3,90.6
3036,48700,"Williamsport, PA (Metropolitan Statistical Area)",2012,37903,129200,2751,131951,126449,4443102,117222,92.7,97.9,75.7,98,92.3
3037,48900,"Wilmington, NC (Metropolitan Statistical Area)",2012,35889,200500,3256,203756,197244,9430156,262759,95.2,96.9,93.7,94.2,94.7
3038,49020,"Winchester, VA-WV (Metropolitan Statistical Area) *",2012,39954,217000,5366,222366,211634,5230407,130910,91.4,91.9,89.4,92.6,91
3039,49180,"Winston-Salem, NC (Metropolitan Statistical Area)",2012,37554,146100,1427,147527,144673,24289933,646794,90.2,97.6,70.2,94.4,89.8
3040,49340,"Worcester, MA-CT (Metropolitan Statistical Area)",2012,46692,267600,1732,269332,265868,43183106,924856,104,100.2,105.7,107.2,103.5
3041,49420,"Yakima, WA (Metropolitan Statistical Area)",2012,35855,157300,2456,159756,154844,8824822,246127,95.5,96.9,81.5,101.3,95
3042,49620,"York-Hanover, PA (Metropolitan Statistical Area)",2012,41989,177200,1765,178965,175435,18368933,437466,96.1,97.9,89.1,98,95.6
3043,49660,"Youngstown-Warren-Boardman, OH-PA (Metropolitan Statistical Area)",2012,36114,98900,831,99731,98069,20170938,558530,88.7,97.7,62.3,95.2,88.3
3044,49700,"Yuba City, CA (Metropolitan Statistical Area)",2012,34729,192000,4164,196164,187836,5798480,166963,98.7,96.9,97.9,101.3,98.2
3045,49740,"Yuma, AZ (Metropolitan Statistical Area) *",2012,27715,125300,4153,129453,121147,5611615,202475,93.9,96.9,77.5,101.3,93.5
3046,10180,"Abilene, TX (Metropolitan Statistical Area)",2011,36325,84800,1914,86714,82886,6052939,166634,90.8,97,74.6,94.1,88.6
3047,10420,"Akron, OH (Metropolitan Statistical Area)",2011,39852,144500,1064,145564,143436,28023720,703200,89,95.1,77.6,88.4,86.9
3048,10500,"Albany, GA (Metropolitan Statistical Area)",2011,32842,104800,3342,108142,101458,5075541,154545,84.6,96.9,56.3,94.1,82.6
3049,10540,"Albany-Lebanon, OR (Metropolitan Statistical Area)",2011,32378,181600,4742,186342,176858,3825868,118164,93.8,98.9,85.3,93.9,91.7
3050,10580,"Albany-Schenectady-Troy, NY (Metropolitan Statistical Area)",2011,45966,194900,1380,196280,193520,40118185,872778,98.6,97.7,102.6,97.7,96.3
3051,10740,"Albuquerque, NM (Metropolitan Statistical Area) *",2011,35609,183800,1594,185394,182206,31977757,898016,97.3,97.6,90.6,100.7,95
3052,10780,"Alexandria, LA (Metropolitan Statistical Area)",2011,36705,108800,3142,111942,105658,5667339,154402,86.4,97.1,58.8,94.2,84.3
3053,10900,"Allentown-Bethlehem-Easton, PA-NJ (Metropolitan Statistical Area)",2011,43461,216800,1643,218443,215157,35852420,824930,100,98.2,102.1,100.9,97.7
3054,11020,"Altoona, PA (Metropolitan Statistical Area)",2011,36891,101500,2931,104431,98569,4684022,126970,90.7,97.7,64.8,97.7,88.6
3055,11100,"Amarillo, TX (Metropolitan Statistical Area)",2011,39413,111700,1907,113607,109793,10088683,255975,92.8,97.4,81.1,94.3,90.6
3056,11180,"Ames, IA (Metropolitan Statistical Area)",2011,36494,159900,2985,162885,156915,4285225,117424,89.9,91.3,89.4,88.7,87.8
3057,11260,"Anchorage, AK (Metropolitan Statistical Area)",2011,55155,256800,3023,259823,253777,21395704,387922,109.4,104.4,138.7,102.9,106.9
3058,11460,"Ann Arbor, MI (Metropolitan Statistical Area)",2011,45054,208800,2502,211302,206298,15757892,349753,102.1,99.5,112,100.7,99.7
3059,11500,"Anniston-Oxford, AL (Metropolitan Statistical Area)",2011,31921,99600,3034,102634,96566,3758530,117744,83.7,97.6,50.4,94.4,81.7
3060,11540,"Appleton, WI (Metropolitan Statistical Area)",2011,40696,156800,1574,158374,155226,9260407,227548,93.2,97.5,80,94.7,91
3061,11700,"Asheville, NC (Metropolitan Statistical Area)",2011,34630,184400,3009,187409,181391,14825509,428113,92.2,96,84.4,93.6,90
3062,12020,"Athens-Clarke County, GA (Metropolitan Statistical Area)",2011,30797,166100,2322,168422,163778,5986133,194375,91.9,97.3,79.5,94.3,89.7
3063,12060,"Atlanta-Sandy Springs-Alpharetta, GA (Metropolitan Statistical Area)",2011,40823,184900,717,185617,184183,219075355,5366462,95.9,98.1,94.7,94.3,93.6
3064,12100,"Atlantic City-Hammonton, NJ (Metropolitan Statistical Area)",2011,40821,256600,3684,260284,252916,11210439,274621,106.9,103.9,107.8,109.3,104.4
3065,12220,"Auburn-Opelika, AL (Metropolitan Statistical Area)",2011,30784,144100,4825,148925,139275,4436858,144130,86.9,92.4,76.3,91.6,84.9
3066,12260,"Augusta-Richmond County, GA-SC (Metropolitan Statistical Area)",2011,34786,123200,1742,124942,121458,19857321,570849,89.5,97.2,69.2,94.3,87.4
3067,12420,"Austin-Round Rock-Georgetown, TX (Metropolitan Statistical Area)",2011,43741,186300,1223,187523,185077,77881693,1780535,98.4,97.6,108.4,94.4,96.1
3068,12540,"Bakersfield, CA (Metropolitan Statistical Area)",2011,32717,196000,2482,198482,193518,27742981,847970,98.2,97.6,95.1,100.8,95.9
3069,12580,"Baltimore-Columbia-Towson, MD (Metropolitan Statistical Area)",2011,50995,297200,1204,298404,295996,139408288,2733785,108.6,101.6,116.6,111,106.1
3070,12620,"Bangor, ME (Metropolitan Statistical Area)",2011,34640,137900,2009,139909,135891,5326232,153759,96.5,97.7,92.4,97.7,94.3
3071,12700,"Barnstable Town, MA (Metropolitan Statistical Area)",2011,55266,384200,3412,387612,380788,11901890,215356,101.8,97.7,117.8,97.7,99.4
3072,12940,"Baton Rouge, LA (Metropolitan Statistical Area)",2011,39895,154700,1193,155893,153507,33172504,831493,92.7,96.6,83.4,93.9,90.5
3073,12980,"Battle Creek, MI (Metropolitan Statistical Area)",2011,32914,107000,1932,108932,105068,4446794,135105,90.8,97.5,71.6,94.7,88.7
3074,13020,"Bay City, MI (Metropolitan Statistical Area)",2011,34579,104600,2413,107013,102187,3714333,107417,88.6,97.5,62.9,94.7,86.5
3075,13140,"Beaumont-Port Arthur, TX (Metropolitan Statistical Area)",2011,36498,91400,1253,92653,90147,14267076,390905,89.8,97.2,68.4,94.3,87.7
3076,13220,"Beckley, WV (Metropolitan Statistical Area)",2011,33570,89100,3318,92418,85782,4205227,125266,75.7,92.4,45.2,91.6,73.9
3077,13380,"Bellingham, WA (Metropolitan Statistical Area)",2011,38418,290400,4428,294828,285972,7817746,203490,99.9,97.6,104,100.8,97.6
3078,13460,"Bend, OR (Metropolitan Statistical Area)",2011,36765,290400,7219,297619,283181,5869857,159660,95.6,98.9,92,93.9,93.3
3079,13740,"Billings, MT (Metropolitan Statistical Area)",2011,41089,174200,2289,176489,171911,6944674,169017,95.8,97.6,83,100.4,93.6
3080,13780,"Binghamton, NY (Metropolitan Statistical Area)",2011,36703,103600,1647,105247,101953,9184468,250238,94.9,97.7,84,97.7,92.7
3081,13820,"Birmingham-Hoover, AL (Metropolitan Statistical Area)",2011,40837,144100,1320,145420,142780,43452289,1064030,90.2,97.3,70.9,94.3,88.1
3082,13900,"Bismarck, ND (Metropolitan Statistical Area)",2011,46985,151700,2176,153876,149524,5302988,112865,91.8,97.1,74.1,94.4,89.7
3083,13980,"Blacksburg-Christiansburg, VA (Metropolitan Statistical Area) *",2011,30258,155700,3620,159320,152080,4945493,163442,89.9,92.5,83.6,91.6,87.8
3084,14020,"Bloomington, IN (Metropolitan Statistical Area)",2011,32099,127700,3174,130874,124526,5191061,161722,95.3,96.9,94,94.1,93
3085,14100,"Bloomsburg-Berwick, PA (Metropolitan Statistical Area)",2011,36735,133100,3391,136491,129709,3138981,85449,92.5,97.7,73.5,97.7,90.3
3086,14260,"Boise City, ID (Metropolitan Statistical Area)",2011,34815,184300,1673,185973,182627,21852159,627670,95.5,97.6,82.4,100.6,93.3
3087,14460,"Boston-Cambridge-Newton, MA-NH (Metropolitan Statistical Area)",2011,60439,373500,912,374412,372588,278612314,4609790,111.4,99,141,111.3,108.8
3088,14500,"Boulder, CO (Metropolitan Statistical Area) *",2011,52309,353000,3810,356810,349190,15690492,299957,108.7,103.5,136.8,100.2,106.1
3089,14540,"Bowling Green, KY (Metropolitan Statistical Area)",2011,31053,132600,2787,135387,129813,4999075,160985,84.8,92.5,62.7,91.7,82.8
3090,14740,"Bremerton-Silverdale-Port Orchard, WA (Metropolitan Statistical Area)",2011,43079,284300,3257,287557,281043,10954944,254297,104.6,104.9,112.5,101,102.2
3091,14860,"Bridgeport-Stamford-Norwalk, CT (Metropolitan Statistical Area)",2011,104079,466700,3589,470289,463111,96584971,928000,121.1,111.7,146.2,120.4,118.2
3092,15180,"Brownsville-Harlingen, TX (Metropolitan Statistical Area)",2011,24111,76000,1194,77194,74806,9962797,413201,84.5,97.6,56.7,94.4,82.6
3093,15260,"Brunswick, GA (Metropolitan Statistical Area)",2011,33262,147700,7324,155024,140376,3755089,112895,85.4,92.4,70.8,91.6,83.4
3094,15380,"Buffalo-Cheektowaga, NY (Metropolitan Statistical Area)",2011,40355,116800,751,117551,116049,45825295,1135562,93.6,97.7,77.8,97.7,91.4
3095,15500,"Burlington, NC (Metropolitan Statistical Area)",2011,33093,136000,2522,138522,133478,5052980,152692,90.5,97.6,72.7,94.4,88.4
3096,15540,"Burlington-South Burlington, VT (Metropolitan Statistical Area)",2011,46750,246600,2532,249132,244068,9968816,213235,101.6,97.7,118,97.7,99.2
3097,15940,"Canton-Massillon, OH (Metropolitan Statistical Area)",2011,36391,125500,1168,126668,124332,14677690,403331,89.6,97.5,65.6,94.7,87.5
3098,15980,"Cape Coral-Fort Myers, FL (Metropolitan Statistical Area)",2011,41397,181000,2525,183525,178475,26123867,631053,96,97.6,95.9,94.4,93.8
3099,16020,"Cape Girardeau, MO-IL (Metropolitan Statistical Area)",2011,34463,122200,3421,125621,118779,3342327,96982,81.8,91.3,63.2,88.7,79.9
3100,16060,"Carbondale-Marion, IL (Metropolitan Statistical Area)",2011,34466,95100,3897,98997,91203,4823707,139956,83.8,91.3,68.5,88.7,81.8
3101,16180,"Carson City, NV (Metropolitan Statistical Area)",2011,43038,244600,8132,252732,236468,2353165,54676,98.2,98.9,103.9,93.9,95.9
3102,16220,"Casper, WY (Metropolitan Statistical Area)",2011,53488,177700,3344,181044,174356,4086409,76399,97.9,97.6,93.3,100.8,95.6
3103,16300,"Cedar Rapids, IA (Metropolitan Statistical Area)",2011,42620,137100,1362,138462,135738,11124960,261028,91.5,96.8,75,94,89.3
3104,16540,"Chambersburg-Waynesboro, PA (Metropolitan Statistical Area)",2011,37921,177800,2940,180740,174860,5723540,150934,94.3,97.7,81.9,97.7,92.1
3105,16580,"Champaign-Urbana, IL (Metropolitan Statistical Area)",2011,39781,141000,1930,142930,139070,8746989,219876,94.2,96.9,88.6,94.1,92
3106,16620,"Charleston, WV (Metropolitan Statistical Area)",2011,37699,100900,2085,102985,98815,10435810,276817,89.4,97.2,65.6,94.2,87.3
3107,16700,"Charleston-North Charleston, SC (Metropolitan Statistical Area)",2011,38773,192000,2408,194408,189592,26414707,681262,95.8,97.6,94.7,94.4,93.5
3108,16740,"Charlotte-Concord-Gastonia, NC-SC (Metropolitan Statistical Area)",2011,40331,171400,992,172392,170408,92005049,2281230,93.2,97.2,83.5,94.2,91
3109,16820,"Charlottesville, VA (Metropolitan Statistical Area) *",2011,48288,283000,4710,287710,278290,9832169,203617,98.7,96.9,113.5,94.1,96.4
3110,16860,"Chattanooga, TN-GA (Metropolitan Statistical Area)",2011,37371,140000,1375,141375,138625,19941818,533621,90,97.3,71,94.3,87.9
3111,16940,"Cheyenne, WY (Metropolitan Statistical Area)",2011,47609,174100,3349,177449,170751,4407469,92576,96.5,97.6,86.1,100.8,94.3
3112,16980,"Chicago-Naperville-Elgin, IL-IN-WI (Metropolitan Statistical Area)",2011,46248,245700,604,246304,245096,439395786,9500870,106.9,104.2,118.4,104.3,104.4
3113,17020,"Chico, CA (Metropolitan Statistical Area)",2011,34425,254900,4635,259535,250265,7572610,219975,100.5,97.6,106.9,100.8,98.1
3114,17140,"Cincinnati, OH-KY-IN (Metropolitan Statistical Area)",2011,43293,156400,712,157112,155688,92916761,2146208,90.9,92.7,80.4,94,88.8
3115,17300,"Clarksville, TN-KY (Metropolitan Statistical Area)",2011,38937,124200,2311,126511,121889,10801230,277405,90.4,97.4,74.1,94.3,88.3
3116,17420,"Cleveland, TN (Metropolitan Statistical Area)",2011,32526,131900,4306,136206,127594,3791567,116569,83.9,92.4,67.6,91.6,82
3117,17460,"Cleveland-Elyria, OH (Metropolitan Statistical Area)",2011,42275,148100,563,148663,147537,87465567,2068989,89.7,95.1,81.4,88.4,87.6
3118,17660,"Coeur d'Alene, ID (Metropolitan Statistical Area)",2011,33731,212300,4969,217269,207331,4753754,140932,93.7,98.9,84.4,93.9,91.5
3119,17780,"College Station-Bryan, TX (Metropolitan Statistical Area)",2011,31521,135000,3548,138548,131452,7295098,231435,93.7,97.1,88,94.2,91.5
3120,17820,"Colorado Springs, CO (Metropolitan Statistical Area)",2011,40153,217600,1500,219100,216100,26527738,660674,99.2,97.6,100.4,100.6,96.9
3121,17860,"Columbia, MO (Metropolitan Statistical Area)",2011,37819,153500,2621,156121,150879,7338091,194030,92.8,97.5,79.8,94.7,90.7
3122,17900,"Columbia, SC (Metropolitan Statistical Area)",2011,35745,138300,1312,139612,136988,27744970,776195,92.2,97.1,80.1,94.2,90
3123,17980,"Columbus, GA-AL (Metropolitan Statistical Area)",2011,34705,131300,3077,134377,128223,10942661,315305,89.7,97.5,71.3,94.4,87.6
3124,18020,"Columbus, IN (Metropolitan Statistical Area)",2011,40420,135400,3662,139062,131738,3137391,77620,87.4,91.3,79.1,88.7,85.3
3125,18140,"Columbus, OH (Metropolitan Statistical Area)",2011,41200,163500,720,164220,162780,79365320,1926338,93.5,97,84.1,94.3,91.4
3126,18580,"Corpus Christi, TX (Metropolitan Statistical Area)",2011,39106,106200,1663,107863,104537,15944465,407721,92.3,97.4,80.4,94.3,90.1
3127,18700,"Corvallis, OR (Metropolitan Statistical Area)",2011,37922,268200,5593,273793,262607,3271409,86266,96.9,98.9,97.8,93.9,94.6
3128,18880,"Crestview-Fort Walton Beach-Destin, FL (Metropolitan Statistical Area)",2011,41562,196800,3200,200000,193600,9921026,238704,95.5,95.6,99.3,93.5,93.3
3129,19060,"Cumberland, MD-WV (Metropolitan Statistical Area)",2011,33050,120700,3267,123967,117433,3391888,102629,88,97.6,62.2,94.4,85.9
3130,19100,"Dallas-Fort Worth-Arlington, TX (Metropolitan Statistical Area)",2011,44888,148700,447,149147,148253,292242374,6510544,100.5,97.7,99.2,104.6,98.2
3131,19140,"Dalton, GA (Metropolitan Statistical Area)",2011,26606,119700,2968,122668,116732,3785621,142285,84.5,92.4,68.2,91.6,82.5
3132,19180,"Danville, IL (Metropolitan Statistical Area)",2011,34240,76100,2531,78631,73569,2787587,81414,79.3,91.3,54.9,88.7,77.5
3133,19300,"Daphne-Fairhope-Foley, AL (Metropolitan Statistical Area)",2011,37881,175700,3794,179494,171906,7067055,186558,93.5,97.6,85.8,94.4,91.3
3134,19340,"Davenport-Moline-Rock Island, IA-IL (Metropolitan Statistical Area)",2011,42588,122400,1213,123613,121187,16212766,380685,91.7,97.3,74.1,94.5,89.5
3135,19460,"Decatur, AL (Metropolitan Statistical Area)",2011,32029,112600,2870,115470,109730,4934854,154075,86.4,97.6,55,94.4,84.4
3136,19500,"Decatur, IL (Metropolitan Statistical Area)",2011,41577,92300,2278,94578,90022,4601890,110684,90,97.5,65.6,94.7,87.9
3137,19660,"Deltona-Daytona Beach-Ormond Beach, FL (Metropolitan Statistical Area)",2011,34369,172100,1791,173891,170309,20343779,591926,95.6,97.6,94.1,94.4,93.4
3138,19740,"Denver-Aurora-Lakewood, CO (Metropolitan Statistical Area) *",2011,47419,246200,848,247048,245352,123428104,2602918,104.1,103.4,112.8,100,101.7
3139,19780,"Des Moines-West Des Moines, IA (Metropolitan Statistical Area)",2011,43337,153700,1313,155013,152387,26795384,618299,95,97.3,90.1,94.5,92.8
3140,19820,"Detroit-Warren-Dearborn, MI (Metropolitan Statistical Area)",2011,40681,148500,590,149090,147910,174592132,4291696,98.2,99.5,90.1,100.7,96
3141,20020,"Dothan, AL (Metropolitan Statistical Area)",2011,34870,107400,2674,110074,104726,5112741,146621,84.9,96.5,55.9,93.9,82.9
3142,20100,"Dover, DE (Metropolitan Statistical Area)",2011,35359,208300,3816,212116,204484,5838109,165110,93.9,97.6,86.5,94.4,91.7
3143,20220,"Dubuque, IA (Metropolitan Statistical Area)",2011,39109,140200,2766,142966,137434,3699412,94593,92.1,97.5,77,94.7,90
3144,20260,"Duluth, MN-WI (Metropolitan Statistical Area)",2011,38564,144000,1849,145849,142151,11206588,290594,92.3,96.9,80.6,94.2,90.1
3145,20500,"Durham-Chapel Hill, NC (Metropolitan Statistical Area)",2011,42446,190000,2659,192659,187341,24301260,572520,95.1,97.4,91.6,94.3,92.9
3146,20700,"East Stroudsburg, PA (Metropolitan Statistical Area)",2011,33436,205400,4792,210192,200608,5680408,169891,98.5,97.7,101.2,97.7,96.2
3147,20740,"Eau Claire, WI (Metropolitan Statistical Area)",2011,38880,148300,1855,150155,146445,6332982,162886,92.5,97.5,78,94.7,90.3
3148,20940,"El Centro, CA (Metropolitan Statistical Area)",2011,31768,169600,4018,173618,165582,5584408,175786,91.2,98.9,75.4,93.9,89.1
3149,21060,"Elizabethtown-Fort Knox, KY (Metropolitan Statistical Area)",2011,35234,130300,4466,134766,125834,5331576,151319,87.3,92.4,77.4,91.6,85.3
3150,21140,"Elkhart-Goshen, IN (Metropolitan Statistical Area)",2011,32387,126600,2186,128786,124414,6421646,198279,92.4,97.5,78.3,94.7,90.2
3151,21300,"Elmira, NY (Metropolitan Statistical Area)",2011,36843,89400,2237,91637,87163,3275325,88899,94,97.7,80.5,97.7,91.8
3152,21340,"El Paso, TX (Metropolitan Statistical Area)",2011,29704,108000,1076,109076,106924,24455648,823308,90.3,97.5,74.2,94.4,88.2
3153,21420,"Enid, OK (Metropolitan Statistical Area)",2011,41340,85500,3133,88633,82367,2511915,60763,(NA),(NA),(NA),(NA),(NA)
3154,21500,"Erie, PA (Metropolitan Statistical Area)",2011,36961,113300,1470,114770,111830,10398013,281327,92.2,97.7,73.3,97.7,90.1
3155,21660,"Eugene-Springfield, OR (Metropolitan Statistical Area)",2011,34892,230900,2003,232903,228897,12352981,354034,98.5,97.6,97,100.8,96.2
3156,21780,"Evansville, IN-KY (Metropolitan Statistical Area)",2011,40447,114100,1720,115820,112380,12647558,312698,91.9,97.5,74.2,94.7,89.7
3157,21820,"Fairbanks, AK (Metropolitan Statistical Area) *",2011,50956,212800,5194,217994,207606,4999795,98120,105.5,98.9,150.3,93.9,103
3158,22020,"Fargo, ND-MN (Metropolitan Statistical Area)",2011,42893,150400,2045,152445,148355,9145648,213222,93.5,97.5,82.9,94.7,91.3
3159,22140,"Farmington, NM (Metropolitan Statistical Area)",2011,32470,154200,4323,158523,149877,4211703,129711,90.8,98.9,70.8,93.9,88.7
3160,22180,"Fayetteville, NC (Metropolitan Statistical Area)",2011,32403,123800,1975,125775,121825,16174151,499149,91.2,97.2,78.1,94.2,89.1
3161,22220,"Fayetteville-Springdale-Rogers, AR (Metropolitan Statistical Area)",2011,43135,150800,1913,152713,148887,19534967,452884,90.3,97.3,71.9,94.2,88.2
3162,22380,"Flagstaff, AZ (Metropolitan Statistical Area)",2011,37093,246600,7576,254176,239024,4980615,134275,97.9,98.9,102.6,93.9,95.6
3163,22420,"Flint, MI (Metropolitan Statistical Area)",2011,32081,109000,1379,110379,107621,13539220,422026,94.1,99.5,71,100.7,91.9
3164,22500,"Florence, SC (Metropolitan Statistical Area)",2011,32700,99900,2739,102639,97161,6729626,205800,85.7,96.4,58.2,93.8,83.7
3165,22520,"Florence-Muscle Shoals, AL (Metropolitan Statistical Area)",2011,32327,104200,2952,107152,101248,4756813,147146,83.8,97.6,48.4,94.4,81.8
3166,22540,"Fond du Lac, WI (Metropolitan Statistical Area)",2011,38284,145200,2556,147756,142644,3897726,101810,86.7,91.3,76.6,88.7,84.7
3167,22660,"Fort Collins, CO (Metropolitan Statistical Area)",2011,39105,244600,2288,246888,242312,11936687,305246,100.7,97.6,108.9,100.8,98.3
3168,22900,"Fort Smith, AR-OK (Metropolitan Statistical Area)",2011,31731,95600,1970,97570,93630,7908546,249236,85.7,97,56.7,94.1,83.7
3169,23060,"Fort Wayne, IN (Metropolitan Statistical Area)",2011,36526,113700,1178,114878,112522,14330275,392332,91.2,97.5,70.8,94.7,89
3170,23420,"Fresno, CA (Metropolitan Statistical Area)",2011,33431,236400,2220,238620,234180,31404880,939406,98.6,97.6,97.2,100.8,96.3
3171,23460,"Gadsden, AL (Metropolitan Statistical Area)",2011,30927,102000,3761,105761,98239,3227845,104369,84.9,97.6,52.7,94.4,82.9
3172,23540,"Gainesville, FL (Metropolitan Statistical Area)",2011,35144,179100,4188,183288,174912,10788478,306979,96.9,97.4,100.1,94.3,94.6
3173,23580,"Gainesville, GA (Metropolitan Statistical Area)",2011,32494,174400,2825,177225,171575,5922592,182269,90.4,92.4,86.5,91.6,88.3
3174,23900,"Gettysburg, PA (Metropolitan Statistical Area)",2011,38827,202800,3933,206733,198867,3939953,101474,95.4,97.7,86.6,97.7,93.2
3175,24020,"Glens Falls, NY (Metropolitan Statistical Area)",2011,37518,164800,2557,167357,162243,4833303,128827,96.7,97.7,92.6,97.7,94.4
3176,24140,"Goldsboro, NC (Metropolitan Statistical Area)",2011,32540,107200,3330,110530,103870,4036149,124038,87,97.6,59.6,94.4,85
3177,24220,"Grand Forks, ND-MN (Metropolitan Statistical Area)",2011,40635,136000,2672,138672,133328,3990067,98194,93.2,97.5,81.7,94.7,91
3178,24260,"Grand Island, NE (Metropolitan Statistical Area)",2011,37399,105100,2386,107486,102714,2750561,73547,83.8,91.3,63.2,88.8,81.8
3179,24300,"Grand Junction, CO (Metropolitan Statistical Area)",2011,35468,222800,3815,226615,218985,5219925,147174,95.5,98.9,91.9,93.9,93.3
3180,24340,"Grand Rapids-Kentwood, MI (Metropolitan Statistical Area)",2011,39063,141100,980,142080,140120,39163203,1002556,93.2,96.8,83.6,94,91
3181,24420,"Grants Pass, OR (Metropolitan Statistical Area)",2011,31045,242600,6017,248617,236583,2567460,82702,93.7,98.9,84.8,93.9,91.5
3182,24500,"Great Falls, MT (Metropolitan Statistical Area)",2011,39540,151200,2478,153678,148722,3231012,81714,94,97.6,75.6,100.8,91.8
3183,24540,"Greeley, CO (Metropolitan Statistical Area) *",2011,35055,193300,2933,196233,190367,9073250,258827,97.4,103.5,85.2,100.2,95.2
3184,24580,"Green Bay, WI (Metropolitan Statistical Area)",2011,41462,157700,1292,158992,156408,12795702,308613,92.2,96.7,79.3,93.9,90.1
3185,24660,"Greensboro-High Point, NC (Metropolitan Statistical Area)",2011,35376,140900,1406,142306,139494,25827833,730095,90.5,97.2,72.9,94.2,88.4
3186,24780,"Greenville, NC (Metropolitan Statistical Area)",2011,33398,124100,3386,127486,120714,5704146,170791,89.2,97.6,67.8,94.4,87.1
3187,24860,"Greenville-Anderson, SC (Metropolitan Statistical Area)",2011,34382,139500,1319,140819,138181,28647783,833220,90.5,97.4,72.6,94.3,88.4
3188,25060,"Gulfport-Biloxi, MS (Metropolitan Statistical Area)",2011,33985,144500,2758,147258,141742,13381283,393744,92,97.6,79.9,94.4,89.9
3189,25180,"Hagerstown-Martinsburg, MD-WV (Metropolitan Statistical Area)",2011,36489,206000,3199,209199,202801,9924300,271983,102.8,107.6,86.9,111,100.4
3190,25220,"Hammond, LA (Metropolitan Statistical Area)",2011,34145,140000,5969,145969,134031,4189651,122700,85.8,92.4,72,91.6,83.8
3191,25260,"Hanford-Corcoran, CA (Metropolitan Statistical Area)",2011,29735,208100,4951,213051,203149,4515822,151868,95.1,98.9,89.9,93.9,92.9
3192,25420,"Harrisburg-Carlisle, PA (Metropolitan Statistical Area)",2011,42481,166200,1061,167261,165139,23461348,552280,96.4,97.7,90.9,97.7,94.2
3193,25500,"Harrisonburg, VA (Metropolitan Statistical Area) *",2011,32005,203000,4484,207484,198516,4058109,126796,92.5,92.4,93.6,91.6,90.3
3194,25540,"Hartford-East Hartford-Middletown, CT (Metropolitan Statistical Area)",2011,52790,258200,1400,259600,256800,64197055,1216088,100.7,98,112.3,98.2,98.3
3195,25620,"Hattiesburg, MS (Metropolitan Statistical Area)",2011,31572,126300,4686,130986,121614,5203051,164801,84.1,92.4,67.8,91.6,82.1
3196,25860,"Hickory-Lenoir-Morganton, NC (Metropolitan Statistical Area)",2011,31099,118700,1889,120589,116811,11334964,364478,89.7,97.6,68.6,94.4,87.6
3197,25940,"Hilton Head Island-Bluffton, SC (Metropolitan Statistical Area)",2011,40484,262200,7156,269356,255044,7664810,189330,93.8,92.4,98.2,91.6,91.6
3198,25980,"Hinesville, GA (Metropolitan Statistical Area)",2011,29570,119100,4437,123537,114663,2373479,80267,89.5,92.4,84.7,91.6,87.4
3199,26140,"Homosassa Springs, FL (Metropolitan Statistical Area)",2011,31537,134800,4320,139120,130480,4407694,139764,90,92.4,86,91.6,87.9
3200,26300,"Hot Springs, AR (Metropolitan Statistical Area)",2011,33072,128400,4716,133116,123684,3203146,96854,84.9,92.4,69.8,91.6,82.9
3201,26380,"Houma-Thibodaux, LA (Metropolitan Statistical Area)",2011,39445,122400,2820,125220,119580,8232784,208713,91.7,97.6,74.9,94.4,89.5
3202,26420,"Houston-The Woodlands-Sugar Land, TX (Metropolitan Statistical Area)",2011,48040,140000,512,140512,139488,290940253,6056193,100.7,98,99,104.8,98.4
3203,26580,"Huntington-Ashland, WV-KY-OH (Metropolitan Statistical Area)",2011,33449,93600,1306,94906,92294,12413939,371126,87.1,97.4,58.1,94.3,85.1
3204,26620,"Huntsville, AL (Metropolitan Statistical Area)",2011,41849,154500,2085,156585,152415,17791117,425122,91.1,97.6,71.9,94.4,88.9
3205,26820,"Idaho Falls, ID (Metropolitan Statistical Area)",2011,34046,157600,2877,160477,154723,4594849,134959,91.3,98.8,74.4,93.9,89.2
3206,26900,"Indianapolis-Carmel-Anderson, IN (Metropolitan Statistical Area)",2011,43987,144500,751,145251,143749,84046895,1910719,93.9,97.4,85.2,94.6,91.7
3207,26980,"Iowa City, IA (Metropolitan Statistical Area)",2011,42936,168900,2624,171524,166276,6694129,155908,95.6,96.9,95.7,94.1,93.4
3208,27060,"Ithaca, NY (Metropolitan Statistical Area)",2011,36581,165900,3553,169453,162347,3724738,101821,103.4,97.7,127.3,97.7,101
3209,27100,"Jackson, MI (Metropolitan Statistical Area)",2011,31504,123200,2249,125449,120951,5029805,159658,90.3,97.5,70.5,94.7,88.2
3210,27140,"Jackson, MS (Metropolitan Statistical Area)",2011,37762,129000,2270,131270,126730,22408334,593409,90.8,97.2,74,94.2,88.6
3211,27180,"Jackson, TN (Metropolitan Statistical Area)",2011,34829,112000,2820,114820,109180,6258411,179692,82.3,92.5,58.8,91.6,80.4
3212,27260,"Jacksonville, FL (Metropolitan Statistical Area)",2011,40237,183300,1745,185045,181555,54801216,1361972,96.5,97.5,97.9,94.4,94.2
3213,27340,"Jacksonville, NC (Metropolitan Statistical Area)",2011,43668,144300,2239,146539,142061,8078221,184993,95.5,97.6,93.7,94.4,93.3
3214,27500,"Janesville-Beloit, WI (Metropolitan Statistical Area)",2011,35772,139000,1671,140671,137329,5718840,159867,93.2,97.5,81.7,94.7,91.1
3215,27620,"Jefferson City, MO (Metropolitan Statistical Area)",2011,35759,131600,2613,134213,128987,5378604,150413,81.1,91.3,58.1,88.7,79.2
3216,27740,"Johnson City, TN (Metropolitan Statistical Area)",2011,33710,123700,2412,126112,121288,6727697,199574,87.7,97.6,62.1,94.4,85.6
3217,27780,"Johnstown, PA (Metropolitan Statistical Area)",2011,35415,87600,1614,89214,85986,5049454,142579,87.1,97.7,53.5,97.7,85
3218,27860,"Jonesboro, AR (Metropolitan Statistical Area)",2011,31512,97100,2947,100047,94153,3871324,122854,81.8,92.4,60.4,91.6,79.9
3219,27900,"Joplin, MO (Metropolitan Statistical Area)",2011,32854,99500,2029,101529,97471,5711575,173846,87.7,97.5,59.2,94.7,85.7
3220,27980,"Kahului-Wailuku-Lahaina, HI (Metropolitan Statistical Area)",2011,37429,594400,9212,603612,585188,5877361,157026,107.9,98.9,155.6,93.9,105.4
3221,28020,"Kalamazoo-Portage, MI (Metropolitan Statistical Area)",2011,38597,139300,1536,140836,137764,9749511,252600,92.8,97.5,79.8,94.7,90.6
3222,28100,"Kankakee, IL (Metropolitan Statistical Area)",2011,33798,147700,3149,150849,144551,3836676,113519,98.7,104.3,81.1,104.3,96.4
3223,28140,"Kansas City, MO-KS (Metropolitan Statistical Area)",2011,43158,159600,652,160252,158948,87415954,2025490,93.9,96.8,84.9,95,91.7
3224,28420,"Kennewick-Richland, WA (Metropolitan Statistical Area)",2011,39116,167500,1752,169252,165748,10306527,263487,97.4,97.6,90,100.8,95.1
3225,28660,"Killeen-Temple, TX (Metropolitan Statistical Area)",2011,38727,114500,2118,116618,112382,15969008,412348,92.3,97.4,81.4,94.3,90.2
3226,28700,"Kingsport-Bristol, TN-VA (Metropolitan Statistical Area) *",2011,34720,113500,1874,115374,111626,10731820,309098,86.4,97.6,57.5,94.4,84.4
3227,28740,"Kingston, NY (Metropolitan Statistical Area)",2011,39623,242500,3536,246036,238964,7229172,182448,102.3,97.7,123.4,97.7,99.9
3228,28940,"Knoxville, TN (Metropolitan Statistical Area)",2011,36732,151800,1423,153223,150377,30146298,820702,89.8,97,71.1,94.1,87.7
3229,29020,"Kokomo, IN (Metropolitan Statistical Area)",2011,33113,105700,2193,107893,103507,2741619,82797,88.6,97.5,62.7,94.7,86.5
3230,29100,"La Crosse-Onalaska, WI-MN (Metropolitan Statistical Area)",2011,40184,151700,2140,153840,149560,5388868,134106,93.6,97.5,83.3,94.7,91.4
3231,29180,"Lafayette, LA (Metropolitan Statistical Area)",2011,39820,145500,3084,148584,142416,18752529,470935,88.8,96.6,67.1,93.9,86.7
3232,29340,"Lake Charles, LA (Metropolitan Statistical Area)",2011,36055,116600,2733,119333,113867,7230341,200534,88.3,97.4,63.4,94.3,86.2
3233,29420,"Lake Havasu City-Kingman, AZ (Metropolitan Statistical Area)",2011,25500,158200,3283,161483,154917,5171712,202812,95.3,97.6,82.4,100.8,93.1
3234,29460,"Lakeland-Winter Haven, FL (Metropolitan Statistical Area)",2011,31851,133200,2121,135321,131079,19427284,609948,94.2,97.6,88.1,94.4,92
3235,29540,"Lancaster, PA (Metropolitan Statistical Area)",2011,39785,187300,1386,188686,185914,20845533,523957,97.8,97.7,97.8,97.7,95.5
3236,29620,"Lansing-East Lansing, MI (Metropolitan Statistical Area)",2011,33940,143600,1378,144978,142222,18212608,536605,94.6,97.5,88.5,94.7,92.4
3237,29700,"Laredo, TX (Metropolitan Statistical Area)",2011,27777,106500,2556,109056,103944,7109093,255935,89.2,97.6,69.7,94.4,87.1
3238,29740,"Las Cruces, NM (Metropolitan Statistical Area)",2011,30748,141900,4086,145986,137814,6553149,213126,92.9,97.6,72.3,100.8,90.7
3239,29820,"Las Vegas-Henderson-Paradise, NV (Metropolitan Statistical Area)",2011,36939,226200,1732,227932,224468,72471475,1961925,100.9,97.6,109.3,100.8,98.6
3240,29940,"Lawrence, KS (Metropolitan Statistical Area)",2011,35010,179900,2947,182847,176953,3937934,112479,95.9,97.5,94.8,94.7,93.6
3241,30020,"Lawton, OK (Metropolitan Statistical Area)",2011,36579,106300,3047,109347,103253,4837705,132255,90.9,97,73.9,94.2,88.8
3242,30140,"Lebanon, PA (Metropolitan Statistical Area)",2011,38470,160800,2240,163040,158560,5175318,134529,94.6,97.7,82.7,97.7,92.4
3243,30300,"Lewiston, ID-WA (Metropolitan Statistical Area)",2011,36072,165900,3121,169021,162779,2215133,61409,90.4,98.9,70.2,93.9,88.3
3244,30340,"Lewiston-Auburn, ME (Metropolitan Statistical Area)",2011,35041,157100,2228,159328,154872,3764767,107439,94.7,97.7,84.6,97.7,92.4
3245,30460,"Lexington-Fayette, KY (Metropolitan Statistical Area)",2011,38809,158600,1620,160220,156980,18586585,478930,92.4,97.6,78.9,94.4,90.3
3246,30620,"Lima, OH (Metropolitan Statistical Area)",2011,34245,105400,3030,108430,102370,3629568,105988,88.1,97.5,60.4,94.7,86
3247,30700,"Lincoln, NE (Metropolitan Statistical Area)",2011,40454,145800,1190,146990,144610,12403925,306619,93.1,97.2,81.5,94.4,90.9
3248,30780,"Little Rock-North Little Rock-Conway, AR (Metropolitan Statistical Area)",2011,38214,132200,1390,133590,130810,27158355,710682,91.5,97.5,75.6,94.3,89.4
3249,30860,"Logan, UT-ID (Metropolitan Statistical Area)",2011,29961,183000,3202,186202,179798,3822793,127591,90.8,98.9,71.6,93.9,88.7
3250,30980,"Longview, TX (Metropolitan Statistical Area)",2011,39696,102900,2398,105298,100502,11211333,282427,91.2,96.7,76.4,94,89.1
3251,31020,"Longview, WA (Metropolitan Statistical Area)",2011,35760,193800,4200,198000,189600,3658562,102309,94.1,98.9,85.6,93.9,91.9
3252,31140,"Louisville/Jefferson County, KY-IN (Metropolitan Statistical Area)",2011,39732,145900,892,146792,145008,48150367,1211869,91,97.3,74,94.2,88.9
3253,31180,"Lubbock, TX (Metropolitan Statistical Area)",2011,34643,104100,1933,106033,102167,10231333,295338,93.5,97.3,84.8,94.3,91.3
3254,31340,"Lynchburg, VA (Metropolitan Statistical Area) *",2011,34236,157300,2372,159672,154928,8702466,254190,90.4,97.4,72.1,94.3,88.3
3255,31420,"Macon-Bibb County, GA (Metropolitan Statistical Area)",2011,34322,120000,2511,122511,117489,7986994,232707,87.5,96.9,63.9,94.1,85.5
3256,31460,"Madera, CA (Metropolitan Statistical Area)",2011,29997,245500,6366,251866,239134,4549836,151675,97.4,97.6,91.4,100.8,95.1
3257,31540,"Madison, WI (Metropolitan Statistical Area)",2011,46263,223500,1251,224751,222249,28366282,613159,97.6,96.8,107.2,94,95.3
3258,31700,"Manchester-Nashua, NH (Metropolitan Statistical Area)",2011,50062,265100,2028,267128,263072,20163586,402774,108.5,98.9,124.8,110.3,105.9
3259,31740,"Manhattan, KS (Metropolitan Statistical Area)",2011,41440,150900,3723,154623,147177,5418176,130746,92.8,91.3,100.3,88.7,90.7
3260,31860,"Mankato, MN (Metropolitan Statistical Area)",2011,37855,165000,2108,167108,162892,3684243,97325,88.1,91.3,82.8,88.7,86.1
3261,31900,"Mansfield, OH (Metropolitan Statistical Area)",2011,32313,110900,2472,113372,108428,3979138,123144,88.3,97.5,61.3,94.7,86.2
3262,32580,"McAllen-Edinburg-Mission, TX (Metropolitan Statistical Area)",2011,22704,75500,1447,76947,74053,18061356,795517,84.4,97.6,54.2,94.4,82.4
3263,32780,"Medford, OR (Metropolitan Statistical Area)",2011,34827,262500,5261,267761,257239,7130728,204747,99.4,97.6,101.2,100.8,97.1
3264,32820,"Memphis, TN-MS-AR (Metropolitan Statistical Area)",2011,38643,136700,1428,138128,135272,51153898,1323741,92.1,97.4,79,94.3,90
3265,32900,"Merced, CA (Metropolitan Statistical Area)",2011,30558,197700,6148,203848,191552,7923689,259297,96.9,97.6,88.9,100.8,94.6
3266,33100,"Miami-Fort Lauderdale-Pompano Beach, FL (Metropolitan Statistical Area)",2011,44381,236900,951,237851,235949,251562531,5668271,104.9,99.6,129.1,97.6,102.4
3267,33140,"Michigan City-La Porte, IN (Metropolitan Statistical Area)",2011,34050,120500,2530,123030,117970,3790314,111317,85.4,91.3,73.5,88.7,83.4
3268,33220,"Midland, MI (Metropolitan Statistical Area)",2011,45313,131900,2850,134750,129050,3797485,83805,92.4,97.5,76.7,94.7,90.2
3269,33260,"Midland, TX (Metropolitan Statistical Area)",2011,97780,133100,4842,137942,128258,14188622,145108,96.4,97.3,98.6,94.3,94.1
3270,33340,"Milwaukee-Waukesha, WI (Metropolitan Statistical Area)",2011,46004,205100,1205,206305,203895,71826004,1561296,95.4,96.2,98.4,93.2,93.1
3271,33460,"Minneapolis-St. Paul-Bloomington, MN-WI (Metropolitan Statistical Area)",2011,49062,234000,592,234592,233408,165504071,3373392,102.5,102,109.7,99.7,100.1
3272,33540,"Missoula, MT (Metropolitan Statistical Area)",2011,36567,239000,4105,243105,234895,4031319,110245,95.9,98.9,93.3,93.9,93.6
3273,33660,"Mobile, AL (Metropolitan Statistical Area)",2011,33613,124100,1986,126086,122114,14467861,430423,88.6,97.6,65.5,94.4,86.5
3274,33700,"Modesto, CA (Metropolitan Statistical Area)",2011,33416,232000,3796,235796,228204,17294715,517560,100,97.6,104.7,100.8,97.7
3275,33740,"Monroe, LA (Metropolitan Statistical Area)",2011,33861,109500,4048,113548,105452,6937642,204886,87,97.2,59,94.2,84.9
3276,33780,"Monroe, MI (Metropolitan Statistical Area)",2011,36134,156600,2179,158779,154421,5474117,151496,96.9,99.5,83.6,100.7,94.7
3277,33860,"Montgomery, AL (Metropolitan Statistical Area)",2011,36379,128700,1981,130681,126719,13661973,375549,90.1,97.5,70.7,94.4,88
3278,34060,"Morgantown, WV (Metropolitan Statistical Area)",2011,35529,132200,4093,136293,128107,4713982,132678,88.8,92.4,80.5,91.6,86.7
3279,34100,"Morristown, TN (Metropolitan Statistical Area)",2011,29739,115000,2789,117789,112211,4090830,137560,81.6,92.4,61.4,91.6,79.7
3280,34580,"Mount Vernon-Anacortes, WA (Metropolitan Statistical Area)",2011,39820,280800,5307,286107,275493,4681927,117578,98.8,98.9,106.6,93.9,96.4
3281,34620,"Muncie, IN (Metropolitan Statistical Area)",2011,29434,92200,1673,93873,90527,3470311,117901,90.3,97.5,71.5,94.7,88.2
3282,34740,"Muskegon, MI (Metropolitan Statistical Area)",2011,30546,108700,1782,110482,106918,5193580,170026,90,97.5,69,94.7,87.9
3283,34820,"Myrtle Beach-Conway-North Myrtle Beach, SC-NC (Metropolitan Statistical Area)",2011,30785,170600,2414,173014,168186,11872402,385650,92.9,96.4,88.3,93.8,90.7
3284,34900,"Napa, CA (Metropolitan Statistical Area)",2011,48880,521700,16598,538298,505102,6730335,137691,118.5,108.1,162,108.5,115.7
3285,34940,"Naples-Marco Island, FL (Metropolitan Statistical Area)",2011,64829,317200,6593,323793,310607,21240021,327629,99.2,97.6,114.5,94.4,96.9
3286,34980,"Nashville-Davidson--Murfreesboro--Franklin, TN (Metropolitan Statistical Area)",2011,43975,172700,983,173683,171717,73638452,1674534,93.9,97.3,87,94.3,91.7
3287,35100,"New Bern, NC (Metropolitan Statistical Area)",2011,36838,148400,4491,152891,143909,4720255,128135,85.8,92.4,73.9,91.6,83.8
3288,35300,"New Haven-Milford, CT (Metropolitan Statistical Area)",2011,46781,270900,1661,272561,269239,40413121,863871,113.5,108.4,118.3,115.9,110.8
3289,35380,"New Orleans-Metairie, LA (Metropolitan Statistical Area)",2011,42676,179500,1103,180603,178397,51808922,1214008,97,97.4,101.2,94.3,94.8
3290,35620,"New York-Newark-Jersey City, NY-NJ-PA (Metropolitan Statistical Area)",2011,57452,440400,828,441228,439572,1094617223,19052774,122.4,108.8,156.5,119.1,119.6
3291,35660,"Niles, MI (Metropolitan Statistical Area)",2011,37467,135400,2680,138080,132720,5878073,156885,90.3,97.5,69.3,94.7,88.2
3292,35840,"North Port-Sarasota-Bradenton, FL (Metropolitan Statistical Area)",2011,43935,205700,2711,208411,202989,31184224,709775,99.2,97.6,110.7,94.4,96.9
3293,35980,"Norwich-New London, CT (Metropolitan Statistical Area)",2011,48438,265700,3230,268930,262470,13225442,273037,101,97.7,115.3,97.7,98.7
3294,36100,"Ocala, FL (Metropolitan Statistical Area)",2011,31218,142000,2607,144607,139393,10373226,332286,92.7,97.6,82.4,94.4,90.6
3295,36140,"Ocean City, NJ (Metropolitan Statistical Area)",2011,46934,332400,6679,339079,325721,4528802,96494,108.9,103.9,116.9,109.3,106.3
3296,36220,"Odessa, TX (Metropolitan Statistical Area)",2011,39573,83100,2672,85772,80428,5526086,139642,93.1,97.6,81,94.4,90.9
3297,36260,"Ogden-Clearfield, UT (Metropolitan Statistical Area)",2011,34028,205900,1961,207861,203939,20607121,605591,96.9,97.7,88.6,100.3,94.6
3298,36420,"Oklahoma City, OK (Metropolitan Statistical Area)",2011,40793,125900,958,126858,124942,52094553,1277045,92,97.4,77.5,94.3,89.8
3299,36500,"Olympia-Lacey-Tumwater, WA (Metropolitan Statistical Area)",2011,41076,259500,3557,263057,255943,10531353,256386,104.6,104.9,111.5,101,102.1
3300,36540,"Omaha-Council Bluffs, NE-IA (Metropolitan Statistical Area)",2011,48605,144800,659,145459,144141,42578963,876022,94.5,97.2,87.9,94.4,92.2
3301,36740,"Orlando-Kissimmee-Sanford, FL (Metropolitan Statistical Area)",2011,34607,201100,1493,202593,199607,75307750,2176054,98.4,97.6,106.7,94.4,96.1
3302,36780,"Oshkosh-Neenah, WI (Metropolitan Statistical Area)",2011,39307,140800,1749,142549,139051,6583641,167493,92.9,97.5,79.4,94.7,90.7
3303,36980,"Owensboro, KY (Metropolitan Statistical Area)",2011,36439,102200,2557,104757,99643,4199734,115255,86.8,97.1,59.8,94.1,84.8
3304,37100,"Oxnard-Thousand Oaks-Ventura, CA (Metropolitan Statistical Area)",2011,48064,515900,5390,521290,510510,39898290,830099,115.3,99.5,169.3,103.3,112.6
3305,37340,"Palm Bay-Melbourne-Titusville, FL (Metropolitan Statistical Area)",2011,38163,171200,1630,172830,169570,20774242,544359,96,97.6,95.7,94.4,93.8
3306,37460,"Panama City, FL (Metropolitan Statistical Area)",2011,37717,168400,3282,171682,165118,6395043,169555,95.7,96.9,96,94.1,93.5
3307,37620,"Parkersburg-Vienna, WV (Metropolitan Statistical Area)",2011,34113,104300,2054,106354,102246,3160333,92643,87.7,97.4,60.1,94.3,85.6
3308,37860,"Pensacola-Ferry Pass-Brent, FL (Metropolitan Statistical Area)",2011,36418,155100,1894,156994,153206,16575331,455139,94.5,97.6,89.3,94.4,92.3
3309,37900,"Peoria, IL (Metropolitan Statistical Area)",2011,42570,125900,1580,127480,124320,17738471,416687,91.6,97.3,73,94.5,89.5
3310,37980,"Philadelphia-Camden-Wilmington, PA-NJ-DE-MD (Metropolitan Statistical Area)",2011,50736,245000,662,245662,244338,304227599,5996232,108,103.9,113.6,109.3,105.5
3311,38060,"Phoenix-Mesa-Chandler, AZ (Metropolitan Statistical Area)",2011,36440,212100,988,213088,211112,154981301,4253037,99.3,99.6,101,98.1,97
3312,38220,"Pine Bluff, AR (Metropolitan Statistical Area)",2011,28873,76400,1929,78329,74471,2859920,99052,84.3,96.8,52.2,94,82.4
3313,38300,"Pittsburgh, PA (Metropolitan Statistical Area)",2011,45148,121100,664,121764,120436,106567831,2360417,93.7,96,76.9,99.2,91.5
3314,38340,"Pittsfield, MA (Metropolitan Statistical Area)",2011,43649,208100,4956,213056,203144,5698228,130547,96.3,97.7,91.2,97.7,94.1
3315,38540,"Pocatello, ID (Metropolitan Statistical Area)",2011,30545,139800,2494,142294,137306,2792444,91421,90.6,98.9,72.1,93.9,88.5
3316,38860,"Portland-South Portland, ME (Metropolitan Statistical Area)",2011,45252,237600,1528,239128,236072,23352951,516070,100.4,97.9,108.8,98.8,98
3317,38900,"Portland-Vancouver-Hillsboro, OR-WA (Metropolitan Statistical Area)",2011,42035,284400,1013,285413,283387,95117802,2262834,100.3,97.9,108.8,99.7,97.9
3318,38940,"Port St. Lucie, FL (Metropolitan Statistical Area)",2011,40766,175100,3205,178305,171895,17459744,428287,96.3,97.6,97.2,94.4,94.1
3319,39100,"Poughkeepsie-Newburgh-Middletown, NY (Metropolitan Statistical Area)",2011,42607,306800,2817,309617,303983,28641808,672230,(NA),(NA),(NA),(NA),(NA)
3320,39300,"Providence-Warwick, RI-MA (Metropolitan Statistical Area)",2011,43871,280300,1072,281372,279228,70323674,1602957,99.9,98,103.1,100.2,97.5
3321,39340,"Provo-Orem, UT (Metropolitan Statistical Area)",2011,27894,233300,1825,235125,231475,15090593,541001,98,97.6,93.9,100.7,95.7
3322,39380,"Pueblo, CO (Metropolitan Statistical Area)",2011,30787,140700,2210,142910,138490,4931525,160184,93.9,97.6,76.7,100.8,91.7
3323,39460,"Punta Gorda, FL (Metropolitan Statistical Area)",2011,33450,166700,3207,169907,163493,5347677,159869,95.6,97.6,94,94.4,93.4
3324,39540,"Racine, WI (Metropolitan Statistical Area)",2011,39957,177300,3039,180339,174261,7787961,194908,93.4,96.2,87.5,93.2,91.3
3325,39580,"Raleigh-Cary, NC (Metropolitan Statistical Area)",2011,43775,202900,1811,204711,201089,50873848,1162179,95.2,97.6,91.5,94.4,93
3326,39660,"Rapid City, SD (Metropolitan Statistical Area)",2011,41541,153600,2438,156038,151162,5313253,127903,91,96.1,77.2,93.4,88.9
3327,39740,"Reading, PA (Metropolitan Statistical Area)",2011,39947,174000,1699,175699,172301,16498351,413008,96.4,97.7,91.3,97.7,94.2
3328,39820,"Redding, CA (Metropolitan Statistical Area)",2011,35564,246800,3969,250769,242831,6315796,177588,99.2,97.6,100.2,100.8,96.9
3329,39900,"Reno, NV (Metropolitan Statistical Area)",2011,45369,256700,5044,261744,251656,19413471,427901,100.5,97.6,107.8,100.7,98.2
3330,40060,"Richmond, VA (Metropolitan Statistical Area) *",2011,45380,227600,1257,228857,226343,54322968,1197059,96.6,97.4,99.3,94.3,94.4
3331,40140,"Riverside-San Bernardino-Ontario, CA (Metropolitan Statistical Area)",2011,31658,281600,1696,283296,279904,135968619,4294897,107.4,99.5,125.2,103.3,104.9
3332,40220,"Roanoke, VA (Metropolitan Statistical Area) *",2011,39266,168600,1792,170392,166808,12138346,309134,91.5,96.9,77.5,94.1,89.3
3333,40340,"Rochester, MN (Metropolitan Statistical Area)",2011,44038,170500,1463,171963,169037,9180822,208473,93.2,95.9,86.4,93.2,91
3334,40380,"Rochester, NY (Metropolitan Statistical Area)",2011,41428,126600,1073,127673,125527,44807052,1081557,97.4,97.7,95.9,97.7,95.1
3335,40420,"Rockford, IL (Metropolitan Statistical Area)",2011,35309,134900,1272,136172,133628,12279650,347773,92.4,97.5,78.3,94.7,90.2
3336,40580,"Rocky Mount, NC (Metropolitan Statistical Area)",2011,32836,101800,3109,104909,98691,4984119,151790,87,97.6,59.2,94.4,84.9
3337,40660,"Rome, GA (Metropolitan Statistical Area)",2011,31314,120000,3918,123918,116082,3011201,96161,82.8,92.4,64.4,91.6,80.8
3338,40900,"Sacramento-Roseville-Folsom, CA (Metropolitan Statistical Area)",2011,43040,324300,1700,326000,322600,93524627,2172948,103.3,97.6,124.5,100.8,100.9
3339,40980,"Saginaw, MI (Metropolitan Statistical Area)",2011,31819,106400,1947,108347,104453,6328820,198899,90,97.5,67.6,94.7,87.9
3340,41060,"St. Cloud, MN (Metropolitan Statistical Area)",2011,36967,171100,1521,172621,169579,7027077,190090,93.4,97.5,83.3,94.7,91.2
3341,41100,"St. George, UT (Metropolitan Statistical Area)",2011,26823,235300,4311,239611,230989,3788671,141249,95,98.9,90.3,93.9,92.8
3342,41140,"St. Joseph, MO-KS (Metropolitan Statistical Area)",2011,33196,108900,2418,111318,106482,4239145,127700,88.3,96.9,63.5,94.1,86.2
3343,41180,"St. Louis, MO-IL (Metropolitan Statistical Area)",2011,43926,160400,591,160991,159809,122780417,2795155,89.9,92.4,83.9,90.1,87.8
3344,41420,"Salem, OR (Metropolitan Statistical Area)",2011,32425,212000,2318,214318,209682,12774828,393978,97,97.9,89.2,99.7,94.7
3345,41500,"Salinas, CA (Metropolitan Statistical Area)",2011,42412,497400,11086,508486,486314,17832488,420456,107.6,97.6,151.4,100.8,105
3346,41540,"Salisbury, MD-DE (Metropolitan Statistical Area)",2011,37950,190200,4113,194313,186087,14352434,378196,89.8,92.4,84.9,91.6,87.7
3347,41620,"Salt Lake City, UT (Metropolitan Statistical Area)",2011,38392,241000,1340,242340,239660,42492172,1106800,99.8,97.6,104.1,100.5,97.5
3348,41660,"San Angelo, TX (Metropolitan Statistical Area)",2011,38619,90700,2894,93594,87806,4422338,114513,91.9,97.5,77,94.4,89.7
3349,41700,"San Antonio-New Braunfels, TX (Metropolitan Statistical Area)",2011,38404,127200,1009,128209,126191,84254324,2193923,93.9,97.3,86.9,94.3,91.7
3350,41740,"San Diego-Chula Vista-Carlsbad, CA (Metropolitan Statistical Area)",2011,46531,455000,2171,457171,452829,145975037,3137156,119.5,103.5,167.4,106.2,116.8
3351,41860,"San Francisco-Oakland-Berkeley, CA (Metropolitan Statistical Area)",2011,65531,627000,2186,629186,624814,288057649,4395725,120.5,108.1,182.5,108.5,117.7
3352,41940,"San Jose-Sunnyvale-Santa Clara, CA (Metropolitan Statistical Area)",2011,65544,674800,2969,677769,671831,122437972,1868031,120.9,107.8,189.3,108.3,118.1
3353,42020,"San Luis Obispo-Paso Robles, CA (Metropolitan Statistical Area)",2011,42698,480200,6884,487084,473316,11573567,271058,107.5,97.6,151.6,100.8,104.9
3354,42100,"Santa Cruz-Watsonville, CA (Metropolitan Statistical Area)",2011,50213,613500,9642,623142,603858,13299282,264858,119.7,108.1,165.1,108.5,116.9
3355,42140,"Santa Fe, NM (Metropolitan Statistical Area)",2011,45321,293900,7116,301016,286784,6609954,145847,99.8,97.6,103.9,100.8,97.5
3356,42220,"Santa Rosa-Petaluma, CA (Metropolitan Statistical Area)",2011,45065,477300,5432,482732,471868,21965851,487421,117.4,108.1,151.1,108.5,114.6
3357,42340,"Savannah, GA (Metropolitan Statistical Area)",2011,39529,172400,2125,174525,170275,14055837,355582,94.9,97.6,91,94.4,92.7
3358,42540,"Scranton--Wilkes-Barre, PA (Metropolitan Statistical Area)",2011,37847,126600,1673,128273,124927,21333430,563676,91.7,97.7,70.8,97.7,89.6
3359,42660,"Seattle-Tacoma-Bellevue, WA (Metropolitan Statistical Area)",2011,51325,352800,1128,353928,351672,179835829,3503891,107.1,104.9,128.8,101,104.6
3360,42680,"Sebastian-Vero Beach, FL (Metropolitan Statistical Area)",2011,57519,179300,5620,184920,173680,8001026,139103,92.8,92.4,94.5,91.6,90.6
3361,42700,"Sebring-Avon Park, FL (Metropolitan Statistical Area)",2011,29590,115600,3887,119487,111713,2913943,98477,85.1,92.4,73,91.6,83.1
3362,43100,"Sheboygan, WI (Metropolitan Statistical Area)",2011,40835,154300,2097,156397,152203,4704538,115208,91.3,97.5,72.8,94.7,89.1
3363,43300,"Sherman-Denison, TX (Metropolitan Statistical Area)",2011,33990,102300,2988,105288,99312,4127422,121430,91.5,97.6,75.1,94.4,89.3
3364,43340,"Shreveport-Bossier City, LA (Metropolitan Statistical Area)",2011,40153,121300,2411,123711,118889,16216912,403880,90.8,97.4,72.4,94.3,88.7
3365,43420,"Sierra Vista-Douglas, AZ (Metropolitan Statistical Area)",2011,35214,155700,3732,159432,151968,4686920,133097,93.2,98.9,82.2,93.9,91
3366,43580,"Sioux City, IA-NE-SD (Metropolitan Statistical Area)",2011,40268,97800,1594,99394,96206,5805449,144171,89.5,95.2,68.9,92.7,87.4
3367,43620,"Sioux Falls, SD (Metropolitan Statistical Area)",2011,47486,150300,1975,152275,148325,11023784,232150,93,97.2,80.6,94.4,90.9
3368,43780,"South Bend-Mishawaka, IN-MI (Metropolitan Statistical Area)",2011,36279,119000,1570,120570,117430,11568795,318884,91.3,96.8,76.2,94,89.2
3369,43900,"Spartanburg, SC (Metropolitan Statistical Area)",2011,33817,118800,2069,120869,116731,9675160,286102,87.9,97.3,64.5,94.3,85.8
3370,44060,"Spokane-Spokane Valley, WA (Metropolitan Statistical Area)",2011,36144,192800,1875,194675,190925,18682412,516889,96.3,97.7,86.4,99.7,94.1
3371,44100,"Springfield, IL (Metropolitan Statistical Area)",2011,40772,120600,1832,122432,118768,8632873,211736,92.6,97.5,75.4,94.7,90.4
3372,44140,"Springfield, MA (Metropolitan Statistical Area)",2011,41163,219700,1405,221105,218295,28732795,698017,96.7,97.8,93.1,97.8,94.5
3373,44180,"Springfield, MO (Metropolitan Statistical Area)",2011,33024,129300,1522,130822,127778,14545002,440432,89.6,97.1,69.3,94.3,87.5
3374,44220,"Springfield, OH (Metropolitan Statistical Area)",2011,33889,110400,2049,112449,108351,4670226,137811,89.8,97.5,66.5,94.7,87.7
3375,44300,"State College, PA (Metropolitan Statistical Area)",2011,37499,181400,3960,185360,177440,5814828,155067,101,97.7,114.2,97.7,98.6
3376,44420,"Staunton, VA (Metropolitan Statistical Area) *",2011,36729,185100,3254,188354,181846,4362447,118774,86.7,92.4,74.8,91.6,84.7
3377,44700,"Stockton, CA (Metropolitan Statistical Area)",2011,33470,264600,3772,268372,260828,23239836,694354,101.8,97.6,114.9,100.8,99.5
3378,44940,"Sumter, SC (Metropolitan Statistical Area)",2011,30052,100900,3247,104147,97653,4267919,142018,88.9,97.6,67,94.4,86.8
3379,45060,"Syracuse, NY (Metropolitan Statistical Area)",2011,39482,119300,867,120167,118433,26155842,662482,95.6,97.7,87.1,97.7,93.3
3380,45220,"Tallahassee, FL (Metropolitan Statistical Area)",2011,36372,173400,2253,175653,171147,13502966,371246,95.1,97.2,92.7,94.2,92.9
3381,45300,"Tampa-St. Petersburg-Clearwater, FL (Metropolitan Statistical Area)",2011,40726,169900,940,170840,168960,114571938,2813269,100,97.9,106.7,98.3,97.6
3382,45460,"Terre Haute, IN (Metropolitan Statistical Area)",2011,31724,86300,1551,87851,84749,6013082,189541,88.7,97,63.9,94.2,86.6
3383,45500,"Texarkana, TX-AR (Metropolitan Statistical Area)",2011,33178,90800,2464,93264,88336,4960568,149515,88,96.7,61.5,94,86
3384,45540,"The Villages, FL (Metropolitan Statistical Area)",2011,33494,186800,4297,191097,182503,3281562,97975,83.8,92.4,73.2,91.6,81.8
3385,45780,"Toledo, OH (Metropolitan Statistical Area)",2011,37657,128100,1341,129441,126759,24483108,650166,90.2,97.5,68.9,94.7,88.1
3386,45820,"Topeka, KS (Metropolitan Statistical Area)",2011,38263,117200,1676,118876,115524,8980168,234696,89.9,96.4,70.4,93.7,87.8
3387,45940,"Trenton-Princeton, NJ (Metropolitan Statistical Area)",2011,56498,302100,4149,306249,297951,20756008,367378,113,101.3,128.4,117.8,110.4
3388,46060,"Tucson, AZ (Metropolitan Statistical Area)",2011,35265,190500,1605,192105,188895,34855621,988381,97.8,97.6,93.1,100.8,95.5
3389,46140,"Tulsa, OK (Metropolitan Statistical Area)",2011,46024,125000,1007,126007,123993,43527586,945750,91.1,97.4,73.3,94.3,89
3390,46220,"Tuscaloosa, AL (Metropolitan Statistical Area)",2011,32598,141200,2959,144159,138241,7835454,240363,87.9,96.6,64.3,94,85.9
3391,46300,"Twin Falls, ID (Metropolitan Statistical Area)",2011,31241,148200,3040,151240,145160,3143447,100620,(NA),(NA),(NA),(NA),(NA)
3392,46340,"Tyler, TX (Metropolitan Statistical Area)",2011,47092,119800,2988,122788,116812,10019529,212764,94.8,97.6,89.5,94.4,92.6
3393,46540,"Utica-Rome, NY (Metropolitan Statistical Area)",2011,36443,101300,1441,102741,99859,10881986,298604,92.5,97.7,73.9,97.7,90.4
3394,46660,"Valdosta, GA (Metropolitan Statistical Area)",2011,30070,126500,3997,130497,122503,4270160,142007,82.5,92.4,65.7,91.6,80.6
3395,46700,"Vallejo, CA (Metropolitan Statistical Area)",2011,39033,340100,4216,344316,335884,16250976,416342,116.3,108.1,144.5,108.5,113.5
3396,47020,"Victoria, TX (Metropolitan Statistical Area)",2011,38916,101200,2880,104080,98320,3687897,94765,91.1,97.3,74.2,94.3,89
3397,47220,"Vineland-Bridgeton, NJ (Metropolitan Statistical Area)",2011,34323,177800,3279,181079,174521,5390192,157043,103.9,103.9,95.5,109.3,101.5
3398,47260,"Virginia Beach-Norfolk-Newport News, VA-NC (Metropolitan Statistical Area) *",2011,42095,246500,1181,247681,245319,72539287,1723208,99.4,97.5,112.3,94.4,97.1
3399,47300,"Visalia, CA (Metropolitan Statistical Area)",2011,32298,191500,2906,194406,188594,14430180,446784,96.5,97.6,86.8,100.8,94.2
3400,47380,"Waco, TX (Metropolitan Statistical Area)",2011,32364,104800,2215,107015,102585,8275409,255700,90.8,97,73.5,94.2,88.7
3401,47460,"Walla Walla, WA (Metropolitan Statistical Area)",2011,36333,201600,6796,208396,194804,2159789,59444,93.7,98.8,82.7,93.9,91.5
3402,47580,"Warner Robins, GA (Metropolitan Statistical Area)",2011,35975,134200,3729,137929,130471,6171977,171561,88.7,97,65.6,94.2,86.6
3403,47900,"Washington-Arlington-Alexandria, DC-VA-MD-WV (Metropolitan Statistical Area) *",2011,61455,399400,984,400384,398416,355350372,5782319,120.2,107.6,166.6,111,117.4
3404,47940,"Waterloo-Cedar Falls, IA (Metropolitan Statistical Area)",2011,38508,123300,1674,124974,121626,6486366,168443,91.2,96.4,75.9,93.6,89
3405,48060,"Watertown-Fort Drum, NY (Metropolitan Statistical Area)",2011,42826,124000,3332,127332,120668,5042888,117752,98.1,97.7,99.6,97.7,95.9
3406,48140,"Wausau-Weston, WI (Metropolitan Statistical Area)",2011,38964,141700,1587,143287,140113,6345048,162844,92.4,97.5,75.8,94.7,90.3
3407,48300,"Wenatchee, WA (Metropolitan Statistical Area)",2011,36006,240700,6153,246853,234547,4028194,111876,96,98.9,93.6,93.9,93.8
3408,48540,"Wheeling, WV-OH (Metropolitan Statistical Area)",2011,34554,87100,1408,88508,85692,5088399,147260,85.6,97.6,51.1,94.4,83.6
3409,48620,"Wichita, KS (Metropolitan Statistical Area)",2011,43330,118000,1078,119078,116922,27095648,625327,91.3,97.2,72.7,94.4,89.2
3410,48660,"Wichita Falls, TX (Metropolitan Statistical Area)",2011,42110,88400,1729,90129,86671,6329537,150311,90,97.3,71.7,94.3,87.9
3411,48700,"Williamsport, PA (Metropolitan Statistical Area)",2011,37009,125400,2775,128175,122625,4320702,116748,90.8,97.7,69.1,97.7,88.7
3412,48900,"Wilmington, NC (Metropolitan Statistical Area)",2011,35436,205600,3426,209026,202174,9182926,259141,94.9,96.9,92.5,94.1,92.7
3413,49020,"Winchester, VA-WV (Metropolitan Statistical Area) *",2011,38382,226600,4753,231353,221847,4987909,129954,91.5,92.4,90.1,91.6,89.4
3414,49180,"Winston-Salem, NC (Metropolitan Statistical Area)",2011,36104,145300,1383,146683,143917,23260575,644266,90.4,97.6,70.8,94.4,88.3
3415,49340,"Worcester, MA-CT (Metropolitan Statistical Area)",2011,44909,274900,1784,276684,273116,41422821,922378,104.3,98.9,106,109.4,101.8
3416,49420,"Yakima, WA (Metropolitan Statistical Area)",2011,33886,154800,2236,157036,152564,8333437,245926,95.8,97.6,82.8,100.8,93.6
3417,49620,"York-Hanover, PA (Metropolitan Statistical Area)",2011,41393,178400,1752,180152,176648,18076311,436701,95.8,97.7,88.2,97.7,93.5
3418,49660,"Youngstown-Warren-Boardman, OH-PA (Metropolitan Statistical Area)",2011,35213,99400,989,100389,98411,19801916,562347,88.5,97.5,60.9,95.3,86.4
3419,49700,"Yuba City, CA (Metropolitan Statistical Area)",2011,34632,216400,4873,221273,211527,5782548,166971,98.8,97.6,98.3,100.8,96.5
3420,49740,"Yuma, AZ (Metropolitan Statistical Area) *",2011,27964,138600,3897,142497,134703,5672331,202841,95.1,97.6,81.6,100.8,92.8
3421,10180,"Abilene, TX (Metropolitan Statistical Area)",2010,34455,83400,2009,85409,81391,5705250,165585,90.4,97.2,72.8,94,86.1
3422,10420,"Akron, OH (Metropolitan Statistical Area)",2010,38244,144800,1117,145917,143683,26886702,703031,88.5,94,77.9,88.1,84.3
3423,10500,"Albany, GA (Metropolitan Statistical Area)",2010,30668,104200,3214,107414,100986,4727287,154145,84.2,97.1,54.3,93.9,80.2
3424,10540,"Albany-Lebanon, OR (Metropolitan Statistical Area)",2010,31636,180300,4177,184477,176123,3697969,116891,95.2,99.3,88.3,94.8,90.7
3425,10580,"Albany-Schenectady-Troy, NY (Metropolitan Statistical Area)",2010,44420,189600,1498,191098,188102,38693831,871082,98.6,97.9,101.7,97.9,94
3426,10740,"Albuquerque, NM (Metropolitan Statistical Area) *",2010,34438,180800,1361,182161,179439,30634965,889558,97,97.1,91.4,100.2,92.5
3427,10780,"Alexandria, LA (Metropolitan Statistical Area)",2010,34792,106100,2637,108737,103463,5361291,154096,86.9,97.4,59.8,94.1,82.8
3428,10900,"Allentown-Bethlehem-Easton, PA-NJ (Metropolitan Statistical Area)",2010,42053,215200,1375,216575,213825,34563981,821923,100.1,98.2,102.1,101,95.3
3429,11020,"Altoona, PA (Metropolitan Statistical Area)",2010,34941,97400,1900,99300,95500,4439095,127045,89.9,97.9,62.9,97.9,85.6
3430,11100,"Amarillo, TX (Metropolitan Statistical Area)",2010,37405,107800,2201,110001,105599,9450943,252664,93,97.6,81.9,94.2,88.6
3431,11180,"Ames, IA (Metropolitan Statistical Area)",2010,34118,156000,2773,158773,153227,3955162,115925,89.7,90,91.6,87.8,85.4
3432,11260,"Anchorage, AK (Metropolitan Statistical Area)",2010,52758,250000,2738,252738,247262,20208961,383053,110.2,105.2,136.1,104.6,105
3433,11460,"Ann Arbor, MI (Metropolitan Statistical Area)",2010,45384,216200,2321,218521,213879,15690064,345717,102.2,99.4,112.4,100.8,97.3
3434,11500,"Anniston-Oxford, AL (Metropolitan Statistical Area)",2010,30927,98200,2126,100326,96074,3661982,118408,83.5,97.8,50.2,94.3,79.6
3435,11540,"Appleton, WI (Metropolitan Statistical Area)",2010,38371,154600,1630,156230,152970,8669917,225948,92.8,97.2,78.5,94.6,88.4
3436,11700,"Asheville, NC (Metropolitan Statistical Area)",2010,33428,181200,2837,184037,178363,14218227,425338,92.5,96.4,85.2,93.3,88.1
3437,12020,"Athens-Clarke County, GA (Metropolitan Statistical Area)",2010,29431,165200,2453,167653,162747,5693052,193439,92.8,97.6,82.6,94.2,88.4
3438,12060,"Atlanta-Sandy Springs-Alpharetta, GA (Metropolitan Statistical Area)",2010,38380,188300,649,188949,187651,203513558,5302598,96.8,98.6,97,94.8,92.2
3439,12100,"Atlantic City-Hammonton, NJ (Metropolitan Statistical Area)",2010,38989,264400,4550,268950,259850,10708168,274648,107.9,105,109.1,110,102.8
3440,12220,"Auburn-Opelika, AL (Metropolitan Statistical Area)",2010,29344,139500,3997,143497,135503,4131431,140794,86.8,93.2,76,90.8,82.7
3441,12260,"Augusta-Richmond County, GA-SC (Metropolitan Statistical Area)",2010,33056,120200,1506,121706,118694,18732472,566694,89,97.5,67.4,94.1,84.8
3442,12420,"Austin-Round Rock-Georgetown, TX (Metropolitan Statistical Area)",2010,40727,180100,1278,181378,178822,70355303,1727502,98.5,97.8,108.4,94.3,93.9
3443,12540,"Bakersfield, CA (Metropolitan Statistical Area)",2010,31031,217100,2247,219347,214853,26097169,840996,98.1,97.1,96.8,100.2,93.4
3444,12580,"Baltimore-Columbia-Towson, MD (Metropolitan Statistical Area)",2010,48716,302500,1554,304054,300946,132299439,2715738,108.9,101,115.8,113.2,103.8
3445,12620,"Bangor, ME (Metropolitan Statistical Area)",2010,33370,133600,2662,136262,130938,5134339,153861,95.8,97.9,88.8,97.9,91.3
3446,12700,"Barnstable Town, MA (Metropolitan Statistical Area)",2010,52395,392700,3537,396237,389163,11312044,215899,102.9,97.9,123.3,97.9,98.1
3447,12940,"Baton Rouge, LA (Metropolitan Statistical Area)",2010,37804,148700,1420,150120,147280,31287421,827629,92.5,96.9,82.1,93.8,88.1
3448,12980,"Battle Creek, MI (Metropolitan Statistical Area)",2010,31904,110300,1712,112012,108588,4337337,135951,91.2,97.2,73.6,94.6,86.9
3449,13020,"Bay City, MI (Metropolitan Statistical Area)",2010,33353,107800,2263,110063,105537,3591408,107679,88.8,97.2,64.2,94.6,84.6
3450,13140,"Beaumont-Port Arthur, TX (Metropolitan Statistical Area)",2010,35082,87200,1071,88271,86129,13655532,389251,89.2,97.5,65.8,94.1,84.9
3451,13220,"Beckley, WV (Metropolitan Statistical Area)",2010,30662,88000,2894,90894,85106,3831216,124949,76.6,93.2,46.2,90.8,73
3452,13380,"Bellingham, WA (Metropolitan Statistical Area)",2010,36787,293500,5823,299323,287677,7414196,201545,99.1,97.1,102.2,100.2,94.5
3453,13460,"Bend, OR (Metropolitan Statistical Area)",2010,34828,314400,7686,322086,306714,5493841,157742,97.1,99.3,96.2,94.8,92.5
3454,13740,"Billings, MT (Metropolitan Statistical Area)",2010,38575,169800,1732,171532,168068,6464005,167571,95.7,97.3,84.1,99.9,91.2
3455,13780,"Binghamton, NY (Metropolitan Statistical Area)",2010,35576,99200,1136,100336,98064,8946988,251489,94.6,97.9,82.5,97.9,90.2
3456,13820,"Birmingham-Hoover, AL (Metropolitan Statistical Area)",2010,39279,141400,1051,142451,140349,41703186,1061717,90.4,97.5,71.1,94.1,86.1
3457,13900,"Bismarck, ND (Metropolitan Statistical Area)",2010,42989,143500,2552,146052,140948,4776622,111112,91.7,96.9,73.1,94.4,87.4
3458,13980,"Blacksburg-Christiansburg, VA (Metropolitan Statistical Area) *",2010,28856,154200,2805,157005,151395,4707296,163131,89.4,93.3,81.5,90.9,85.2
3459,14020,"Bloomington, IN (Metropolitan Statistical Area)",2010,30687,124100,2563,126663,121537,4913993,160132,94.1,96.6,90,94.1,89.6
3460,14100,"Bloomsburg-Berwick, PA (Metropolitan Statistical Area)",2010,34778,123700,2474,126174,121226,2978939,85657,93.3,97.9,75.5,97.9,88.9
3461,14260,"Boise City, ID (Metropolitan Statistical Area)",2010,33563,190200,1643,191843,188557,20737699,617866,95.8,97.2,85.5,100,91.3
3462,14460,"Boston-Cambridge-Newton, MA-NH (Metropolitan Statistical Area)",2010,58062,382400,871,383271,381529,265132347,4566348,111.5,97.5,141,114,106.2
3463,14500,"Boulder, CO (Metropolitan Statistical Area) *",2010,50465,353300,3514,356814,349786,14889031,295037,108.1,104,135.9,99.5,103
3464,14540,"Bowling Green, KY (Metropolitan Statistical Area)",2010,29703,129200,2525,131725,126675,4732922,159341,84.7,93.4,62,90.9,80.7
3465,14740,"Bremerton-Silverdale-Port Orchard, WA (Metropolitan Statistical Area)",2010,42275,284700,3849,288549,280851,10639890,251681,104.1,105.1,108.4,101.1,99.2
3466,14860,"Bridgeport-Stamford-Norwalk, CT (Metropolitan Statistical Area)",2010,103725,477700,4192,481892,473508,95360433,919355,121.4,112.1,144.4,121,115.7
3467,15180,"Brownsville-Harlingen, TX (Metropolitan Statistical Area)",2010,23352,74000,1344,75344,72656,9518840,407630,84.2,97.8,56,94.3,80.3
3468,15260,"Brunswick, GA (Metropolitan Statistical Area)",2010,31966,146100,7076,153176,139024,3597292,112534,85.4,93.2,69.9,90.8,81.4
3469,15380,"Buffalo-Cheektowaga, NY (Metropolitan Statistical Area)",2010,38726,113900,742,114642,113158,43978449,1135627,93.4,97.9,76.5,97.9,89
3470,15500,"Burlington, NC (Metropolitan Statistical Area)",2010,32004,137100,2685,139785,134415,4846334,151431,91,97.8,73.9,94.3,86.7
3471,15540,"Burlington-South Burlington, VT (Metropolitan Statistical Area)",2010,43912,240200,1977,242177,238223,9289099,211538,101.7,97.9,117,97.9,96.9
3472,15940,"Canton-Massillon, OH (Metropolitan Statistical Area)",2010,33964,126600,1422,128022,125178,13728976,404218,89.7,97.2,66.1,94.6,85.4
3473,15980,"Cape Coral-Fort Myers, FL (Metropolitan Statistical Area)",2010,39095,210600,2585,213185,208015,24256409,620449,97.2,97.8,101,94.3,92.6
3474,16020,"Cape Girardeau, MO-IL (Metropolitan Statistical Area)",2010,33124,118300,3108,121408,115192,3194740,96447,80.6,90,61.3,87.8,76.8
3475,16060,"Carbondale-Marion, IL (Metropolitan Statistical Area)",2010,33481,96100,3736,99836,92364,4667562,139409,82,90,66.4,87.8,78.1
3476,16180,"Carson City, NV (Metropolitan Statistical Area)",2010,44233,270500,8635,279135,261865,2431986,54981,99.7,99.3,108.5,94.8,94.9
3477,16220,"Casper, WY (Metropolitan Statistical Area)",2010,49395,173300,3038,176338,170262,3727816,75470,96.3,97.1,87.8,100.2,91.8
3478,16300,"Cedar Rapids, IA (Metropolitan Statistical Area)",2010,40931,133900,1261,135161,132639,10578111,258440,91.2,96.4,75.1,93.9,86.9
3479,16540,"Chambersburg-Waynesboro, PA (Metropolitan Statistical Area)",2010,36017,175000,2989,177989,172011,5399921,149925,94.5,97.9,82.1,97.9,90
3480,16580,"Champaign-Urbana, IL (Metropolitan Statistical Area)",2010,38533,138400,1872,140272,136528,8410121,218255,93.8,96.5,87.9,94,89.4
3481,16620,"Charleston, WV (Metropolitan Statistical Area)",2010,35847,99000,1528,100528,97472,9958597,277805,88.4,97.4,62.6,94.1,84.3
3482,16700,"Charleston-North Charleston, SC (Metropolitan Statistical Area)",2010,36405,192400,2091,194491,190309,24298555,667450,95.6,97.8,93.4,94.3,91
3483,16740,"Charlotte-Concord-Gastonia, NC-SC (Metropolitan Statistical Area)",2010,38690,169300,963,170263,168337,87057935,2250121,93.3,97.4,83.6,94.1,88.9
3484,16820,"Charlottesville, VA (Metropolitan Statistical Area) *",2010,46096,283700,4608,288308,279092,9306406,201891,98.6,97.2,112.4,93.9,93.9
3485,16860,"Chattanooga, TN-GA (Metropolitan Statistical Area)",2010,35629,136400,1599,137999,134801,18852194,529131,90.1,97.6,71.2,94.2,85.8
3486,16940,"Cheyenne, WY (Metropolitan Statistical Area)",2010,42684,169900,3264,173164,166636,3936992,92236,95.2,97.1,81.6,100.2,90.7
3487,16980,"Chicago-Naperville-Elgin, IL-IN-WI (Metropolitan Statistical Area)",2010,44208,251100,757,251857,250343,418681182,9470634,106.8,104.7,117.9,103.5,101.7
3488,17020,"Chico, CA (Metropolitan Statistical Area)",2010,33234,265400,4711,270111,260689,7309787,219949,100.1,97.1,107.2,100.2,95.4
3489,17140,"Cincinnati, OH-KY-IN (Metropolitan Statistical Area)",2010,40366,156300,654,156954,155646,86411968,2140715,91.7,93.8,80.5,95,87.3
3490,17300,"Clarksville, TN-KY (Metropolitan Statistical Area)",2010,36091,119300,1946,121246,117354,9923549,274959,89.6,97.6,71.6,94.2,85.4
3491,17420,"Cleveland, TN (Metropolitan Statistical Area)",2010,30741,129000,3755,132755,125245,3562789,115896,83.7,93.2,66.8,90.8,79.8
3492,17460,"Cleveland-Elyria, OH (Metropolitan Statistical Area)",2010,39604,149600,567,150167,149033,82196381,2075478,89.3,94,82,88.1,85.1
3493,17660,"Coeur d'Alene, ID (Metropolitan Statistical Area)",2010,32135,220000,3977,223977,216023,4461860,138848,94.3,99.3,85,94.8,89.9
3494,17780,"College Station-Bryan, TX (Metropolitan Statistical Area)",2010,30366,129500,3506,133006,125994,6967703,229458,92.8,97.3,84.5,94,88.4
3495,17820,"Colorado Springs, CO (Metropolitan Statistical Area)",2010,38268,217200,1676,218876,215524,24893157,650500,98.7,97.2,99.8,100.1,94
3496,17860,"Columbia, MO (Metropolitan Statistical Area)",2010,36445,150300,3083,153383,147217,6958980,190947,92.8,97.2,80,94.6,88.4
3497,17900,"Columbia, SC (Metropolitan Statistical Area)",2010,34470,135400,1259,136659,134141,26529741,769646,92.1,97.3,79.6,94,87.8
3498,17980,"Columbus, GA-AL (Metropolitan Statistical Area)",2010,32738,127800,2369,130169,125431,10131715,309476,89.1,97.7,69.6,94.3,84.9
3499,18020,"Columbus, IN (Metropolitan Statistical Area)",2010,37669,133100,3280,136380,129820,2893676,76818,86.2,90,77.6,87.8,82.1
3500,18140,"Columbus, OH (Metropolitan Statistical Area)",2010,38542,163200,678,163878,162522,73474721,1906366,93.3,96.7,83.9,94.2,88.9
3501,18580,"Corpus Christi, TX (Metropolitan Statistical Area)",2010,36331,102300,1575,103875,100725,14702307,404676,92.7,97.6,81.6,94.2,88.3
3502,18700,"Corvallis, OR (Metropolitan Statistical Area)",2010,36056,263200,5916,269116,257284,3085491,85574,97.4,99.3,97.5,94.8,92.8
3503,18880,"Crestview-Fort Walton Beach-Destin, FL (Metropolitan Statistical Area)",2010,40519,204400,3617,208017,200783,9559627,235932,95.8,96,100.1,93.1,91.2
3504,19060,"Cumberland, MD-WV (Metropolitan Statistical Area)",2010,31776,116200,3191,119391,113009,3278334,103170,88.5,97.8,63.1,94.3,84.3
3505,19100,"Dallas-Fort Worth-Arlington, TX (Metropolitan Statistical Area)",2010,40995,147200,534,147734,146666,262043276,6392065,100.8,98.2,98.9,105.1,96.1
3506,19140,"Dalton, GA (Metropolitan Statistical Area)",2010,25665,120200,3199,123399,117001,3651564,142278,86,93.2,72.2,90.8,82
3507,19180,"Danville, IL (Metropolitan Statistical Area)",2010,32432,76500,2258,78758,74242,2647762,81640,79,90,55.6,87.8,75.2
3508,19300,"Daphne-Fairhope-Foley, AL (Metropolitan Statistical Area)",2010,36143,177200,3948,181148,173252,6618292,183112,93.7,97.8,86.1,94.3,89.3
3509,19340,"Davenport-Moline-Rock Island, IA-IL (Metropolitan Statistical Area)",2010,40012,120400,1229,121629,119171,15194129,379743,91.6,97,74,94.4,87.2
3510,19460,"Decatur, AL (Metropolitan Statistical Area)",2010,31300,111100,2943,114043,108157,4818572,153950,87.3,97.8,57,94.3,83.1
3511,19500,"Decatur, IL (Metropolitan Statistical Area)",2010,39425,90500,1970,92470,88530,4367830,110787,89.3,97.2,64,94.6,85.1
3512,19660,"Deltona-Daytona Beach-Ormond Beach, FL (Metropolitan Statistical Area)",2010,33358,186300,2213,188513,184087,19697921,590506,96.2,97.8,96.4,94.3,91.7
3513,19740,"Denver-Aurora-Lakewood, CO (Metropolitan Statistical Area) *",2010,43665,246200,664,246864,245536,111542391,2554523,103.9,103.9,112,99.4,99
3514,19780,"Des Moines-West Des Moines, IA (Metropolitan Statistical Area)",2010,41913,151100,1118,152218,149982,25522229,608930,94.6,97,88.6,94.4,90.1
3515,19820,"Detroit-Warren-Dearborn, MI (Metropolitan Statistical Area)",2010,37995,157700,502,158202,157198,163054960,4291508,98.6,99.4,91.5,100.8,93.9
3516,20020,"Dothan, AL (Metropolitan Statistical Area)",2010,33760,101900,3213,105113,98687,4924610,145871,84.4,96.9,54.2,93.7,80.4
3517,20100,"Dover, DE (Metropolitan Statistical Area)",2010,33846,207500,4049,211549,203451,5515453,162956,93.2,97.8,83.3,94.3,88.8
3518,20220,"Dubuque, IA (Metropolitan Statistical Area)",2010,36866,136800,2726,139526,134074,3462798,93929,91.8,97.2,75.3,94.6,87.4
3519,20260,"Duluth, MN-WI (Metropolitan Statistical Area)",2010,36393,142600,1491,144091,141109,10573803,290542,91.8,96.6,79.2,94.1,87.5
3520,20500,"Durham-Chapel Hill, NC (Metropolitan Statistical Area)",2010,41046,184400,2329,186729,182071,23242852,566267,95.1,97.6,91.2,94.2,90.6
3521,20700,"East Stroudsburg, PA (Metropolitan Statistical Area)",2010,31907,206400,3952,210352,202448,5419411,169849,98.8,97.9,101.8,97.9,94.1
3522,20740,"Eau Claire, WI (Metropolitan Statistical Area)",2010,37105,146900,2058,148958,144842,5998210,161655,92.4,97.2,78.3,94.6,88
3523,20940,"El Centro, CA (Metropolitan Statistical Area)",2010,29457,192600,5725,198325,186875,5146671,174716,91.6,99.3,75,94.8,87.3
3524,21060,"Elizabethtown-Fort Knox, KY (Metropolitan Statistical Area)",2010,33849,127000,4008,131008,122992,5071684,149833,86.5,93.2,74.7,90.8,82.4
3525,21140,"Elkhart-Goshen, IN (Metropolitan Statistical Area)",2010,30403,128000,2109,130109,125891,6003170,197451,93,97.2,81.1,94.6,88.6
3526,21300,"Elmira, NY (Metropolitan Statistical Area)",2010,35207,85900,1860,87760,84040,3129717,88895,93.7,97.9,78.8,97.9,89.2
3527,21340,"El Paso, TX (Metropolitan Statistical Area)",2010,28366,101800,1232,103032,100568,22892407,807048,89.4,97.7,71.3,94.3,85.2
3528,21420,"Enid, OK (Metropolitan Statistical Area)",2010,39063,82100,2902,85002,79198,2373651,60765,(NA),(NA),(NA),(NA),(NA)
3529,21500,"Erie, PA (Metropolitan Statistical Area)",2010,34606,111300,1537,112837,109763,9717399,280799,91.9,97.9,72.1,97.9,87.6
3530,21660,"Eugene-Springfield, OR (Metropolitan Statistical Area)",2010,33862,230000,2189,232189,227811,11916860,351920,97.8,97.1,95.5,100.2,93.2
3531,21780,"Evansville, IN-KY (Metropolitan Statistical Area)",2010,37903,113800,1917,115717,111883,11818127,311802,91.6,97.2,73.6,94.6,87.2
3532,21820,"Fairbanks, AK (Metropolitan Statistical Area) *",2010,46225,206800,5230,212030,201570,4542248,98264,105.5,99.3,148.5,94.8,100.6
3533,22020,"Fargo, ND-MN (Metropolitan Statistical Area)",2010,40198,147400,1734,149134,145666,8419670,209455,93.4,97.2,82.7,94.6,88.9
3534,22140,"Farmington, NM (Metropolitan Statistical Area)",2010,30428,149400,5642,155042,143758,3961771,130203,92,99.3,72.5,94.7,87.7
3535,22180,"Fayetteville, NC (Metropolitan Statistical Area)",2010,31674,116900,1789,118689,115111,15534312,490446,91.2,97.4,77.7,94.1,86.9
3536,22220,"Fayetteville-Springdale-Rogers, AR (Metropolitan Statistical Area)",2010,38641,150700,1628,152328,149072,17091019,442301,89.9,97.5,70.8,94.1,85.7
3537,22380,"Flagstaff, AZ (Metropolitan Statistical Area)",2010,34408,257700,7956,265656,249744,4631674,134612,98.4,99.3,102.5,94.8,93.7
3538,22420,"Flint, MI (Metropolitan Statistical Area)",2010,30420,118000,1309,119309,116691,12926987,424953,94.2,99.4,71,100.8,89.8
3539,22500,"Florence, SC (Metropolitan Statistical Area)",2010,31344,97500,1948,99448,95552,6446200,205662,85.1,96.7,56.3,93.6,81.1
3540,22520,"Florence-Muscle Shoals, AL (Metropolitan Statistical Area)",2010,31257,102600,2641,105241,99959,4602964,147261,83.5,97.8,48,94.3,79.6
3541,22540,"Fond du Lac, WI (Metropolitan Statistical Area)",2010,36857,143000,2159,145159,140841,3743813,101576,85.8,90,75.8,87.8,81.7
3542,22660,"Fort Collins, CO (Metropolitan Statistical Area)",2010,37455,246000,2412,248412,243588,11252959,300441,99.7,97.1,105.7,100.2,95
3543,22900,"Fort Smith, AR-OK (Metropolitan Statistical Area)",2010,29787,92400,1565,93965,90835,7397525,248344,86,97.3,57.3,94,81.9
3544,23060,"Fort Wayne, IN (Metropolitan Statistical Area)",2010,34456,113800,1196,114996,112604,13413626,389298,91.1,97.2,71.2,94.6,86.8
3545,23420,"Fresno, CA (Metropolitan Statistical Area)",2010,31724,257000,2977,259977,254023,29567869,932039,98.1,97.1,96.8,100.2,93.4
3546,23460,"Gadsden, AL (Metropolitan Statistical Area)",2010,30344,98200,3882,102082,94318,3169689,104459,85.6,97.8,53.5,94.3,81.6
3547,23540,"Gainesville, FL (Metropolitan Statistical Area)",2010,33992,182400,3331,185731,179069,10378911,305334,97.9,97.6,104.2,94.2,93.3
3548,23580,"Gainesville, GA (Metropolitan Statistical Area)",2010,30562,175200,4646,179846,170554,5502166,180033,90,93.2,84.7,90.8,85.7
3549,23900,"Gettysburg, PA (Metropolitan Statistical Area)",2010,37331,200700,4004,204704,196696,3788328,101479,95.5,97.9,86.6,97.9,91
3550,24020,"Glens Falls, NY (Metropolitan Statistical Area)",2010,36048,160600,2516,163116,158084,4650940,129021,96.5,97.9,91.4,97.9,92
3551,24140,"Goldsboro, NC (Metropolitan Statistical Area)",2010,31611,104800,3098,107898,101702,3884495,122886,87.1,97.8,60,94.3,83
3552,24220,"Grand Forks, ND-MN (Metropolitan Statistical Area)",2010,37696,131800,2529,134329,129271,3718077,98633,93.2,97.2,81.9,94.6,88.8
3553,24260,"Grand Island, NE (Metropolitan Statistical Area)",2010,34414,102000,2548,104548,99452,2510001,72936,82.8,90,62.2,88,78.9
3554,24300,"Grand Junction, CO (Metropolitan Statistical Area)",2010,34234,221000,3225,224225,217775,5007084,146259,96.6,99.3,94.3,94.8,92.1
3555,24340,"Grand Rapids-Kentwood, MI (Metropolitan Statistical Area)",2010,36191,143900,1011,144911,142889,35983765,994262,93.2,96.4,84.5,93.9,88.8
3556,24420,"Grants Pass, OR (Metropolitan Statistical Area)",2010,30081,253600,7015,260615,246585,2493113,82879,93.4,99.3,82.1,94.8,89
3557,24500,"Great Falls, MT (Metropolitan Statistical Area)",2010,38344,146600,2660,149260,143940,3125339,81507,93.4,97.1,75.1,100.2,89
3558,24540,"Greeley, CO (Metropolitan Statistical Area) *",2010,33092,195700,2468,198168,193232,8412326,254207,98.1,104,87.2,99.5,93.5
3559,24580,"Green Bay, WI (Metropolitan Statistical Area)",2010,39375,156800,1363,158163,155437,12078452,306754,91.9,96.3,78.5,93.8,87.6
3560,24660,"Greensboro-High Point, NC (Metropolitan Statistical Area)",2010,34394,138600,1143,139743,137457,24944816,725264,90.6,97.4,73.3,94.1,86.3
3561,24780,"Greenville, NC (Metropolitan Statistical Area)",2010,32567,118600,2886,121486,115714,5499331,168863,89.4,97.8,68.7,94.3,85.2
3562,24860,"Greenville-Anderson, SC (Metropolitan Statistical Area)",2010,32822,136700,1412,138112,135288,27098891,825625,90.3,97.6,71.6,94.2,86
3563,25060,"Gulfport-Biloxi, MS (Metropolitan Statistical Area)",2010,34045,141600,2161,143761,139439,13254712,389324,93.5,97.8,85,94.3,89.1
3564,25180,"Hagerstown-Martinsburg, MD-WV (Metropolitan Statistical Area)",2010,35044,215200,2314,217514,212886,9456119,269833,102.7,107,86,112.8,97.9
3565,25220,"Hammond, LA (Metropolitan Statistical Area)",2010,32891,133400,7041,140441,126359,3995727,121485,85.6,93.2,71.3,90.8,81.6
3566,25260,"Hanford-Corcoran, CA (Metropolitan Statistical Area)",2010,26717,220400,4802,225202,215598,4070894,152370,95.8,99.3,90.4,94.8,91.2
3567,25420,"Harrisburg-Carlisle, PA (Metropolitan Statistical Area)",2010,40597,161900,1197,163097,160703,22331977,550088,96.3,97.9,90,97.9,91.8
3568,25500,"Harrisonburg, VA (Metropolitan Statistical Area) *",2010,30644,198000,4041,202041,193959,3842746,125401,92.3,93.2,92.8,90.8,88
3569,25540,"Hartford-East Hartford-Middletown, CT (Metropolitan Statistical Area)",2010,50633,257700,1753,259453,255947,61473373,1214091,100.8,98.1,112,98.4,96
3570,25620,"Hattiesburg, MS (Metropolitan Statistical Area)",2010,30503,123600,4161,127761,119439,4967645,162856,84.7,93.2,68.8,90.8,80.7
3571,25860,"Hickory-Lenoir-Morganton, NC (Metropolitan Statistical Area)",2010,30311,118600,1602,120202,116998,11080715,365565,89.6,97.8,68.2,94.3,85.4
3572,25940,"Hilton Head Island-Bluffton, SC (Metropolitan Statistical Area)",2010,38260,260000,8372,268372,251628,7184360,187777,95.3,93.2,103.4,90.8,90.8
3573,25980,"Hinesville, GA (Metropolitan Statistical Area)",2010,28242,112200,4372,116572,107828,2184222,77339,89.1,93.2,83.4,90.8,84.9
3574,26140,"Homosassa Springs, FL (Metropolitan Statistical Area)",2010,30619,141800,2706,144506,139094,4322621,141173,90.5,93.2,87,90.8,86.2
3575,26300,"Hot Springs, AR (Metropolitan Statistical Area)",2010,31722,126900,4630,131530,122270,3047426,96067,84.4,93.2,68.1,90.8,80.4
3576,26380,"Houma-Thibodaux, LA (Metropolitan Statistical Area)",2010,39364,116900,2541,119441,114359,8197584,208251,90.3,97.8,69.1,94.3,86.1
3577,26420,"Houston-The Woodlands-Sugar Land, TX (Metropolitan Statistical Area)",2010,44998,138000,533,138533,137467,267613203,5947236,100.7,98.7,98.6,104.2,95.9
3578,26580,"Huntington-Ashland, WV-KY-OH (Metropolitan Statistical Area)",2010,32199,92700,1414,94114,91286,11948084,371065,86.2,97.6,55.8,94.2,82.1
3579,26620,"Huntsville, AL (Metropolitan Statistical Area)",2010,40114,149400,1868,151268,147532,16818957,419276,90.9,97.8,70.9,94.3,86.6
3580,26820,"Idaho Falls, ID (Metropolitan Statistical Area)",2010,32810,153500,2827,156327,150673,4390404,133813,92.2,99.3,75.1,94.7,87.9
3581,26900,"Indianapolis-Carmel-Anderson, IN (Metropolitan Statistical Area)",2010,41344,143700,592,144292,143108,78248853,1892640,93.8,97.1,85,94.5,89.3
3582,26980,"Iowa City, IA (Metropolitan Statistical Area)",2010,40042,167200,2450,169650,164750,6127366,153025,95.4,96.6,95.1,94,90.8
3583,27060,"Ithaca, NY (Metropolitan Statistical Area)",2010,34966,162100,2967,165067,159133,3557402,101740,103.3,97.9,125.7,97.9,98.4
3584,27100,"Jackson, MI (Metropolitan Statistical Area)",2010,30354,130000,3107,133107,126893,4859884,160109,90,97.2,69.9,94.6,85.7
3585,27140,"Jackson, MS (Metropolitan Statistical Area)",2010,35797,124500,1811,126311,122689,21058623,588272,90.4,97.4,72.3,94.1,86.1
3586,27180,"Jackson, TN (Metropolitan Statistical Area)",2010,32175,110800,2566,113366,108234,5783868,179762,82.8,93.3,59.7,90.9,78.9
3587,27260,"Jacksonville, FL (Metropolitan Statistical Area)",2010,38721,191800,1705,193505,190095,52230908,1348907,96.7,97.7,98.9,94.3,92.2
3588,27340,"Jacksonville, NC (Metropolitan Statistical Area)",2010,41879,137400,2635,140035,134765,7826773,186892,94.9,97.8,91.1,94.3,90.4
3589,27500,"Janesville-Beloit, WI (Metropolitan Statistical Area)",2010,33820,138000,1688,139688,136312,5419969,160260,92.4,97.2,78.8,94.6,88.1
3590,27620,"Jefferson City, MO (Metropolitan Statistical Area)",2010,34884,129000,2642,131642,126358,5232220,149991,80.9,90,59.1,87.8,77.1
3591,27740,"Johnson City, TN (Metropolitan Statistical Area)",2010,31788,119400,2454,121854,116946,6326071,199010,88.1,97.8,63.3,94.3,83.9
3592,27780,"Johnstown, PA (Metropolitan Statistical Area)",2010,32850,86000,1211,87211,84789,4712750,143461,85.8,97.9,50.2,97.9,81.7
3593,27860,"Jonesboro, AR (Metropolitan Statistical Area)",2010,29781,94800,2745,97545,92055,3611286,121263,80.2,93.2,57.1,90.8,76.4
3594,27900,"Joplin, MO (Metropolitan Statistical Area)",2010,30700,96000,1938,97938,94062,5398097,175833,88,97.2,60.4,94.6,83.9
3595,27980,"Kahului-Wailuku-Lahaina, HI (Metropolitan Statistical Area)",2010,35695,614600,10126,624726,604474,5536704,155110,109.2,99.3,159.5,94.8,104
3596,28020,"Kalamazoo-Portage, MI (Metropolitan Statistical Area)",2010,36408,141300,1712,143012,139588,9129445,250751,93.3,97.2,82.4,94.6,88.9
3597,28100,"Kankakee, IL (Metropolitan Statistical Area)",2010,32804,148400,3097,151497,145303,3720617,113418,97.8,104.8,78.3,103.6,93.1
3598,28140,"Kansas City, MO-KS (Metropolitan Statistical Area)",2010,41103,158000,672,158672,157328,82754866,2013361,92.9,96.5,84.9,92.9,88.5
3599,28420,"Kennewick-Richland, WA (Metropolitan Statistical Area)",2010,37809,163300,1708,165008,161592,9661802,255542,96.2,97.1,86.8,100.2,91.7
3600,28660,"Killeen-Temple, TX (Metropolitan Statistical Area)",2010,37150,110600,1456,112056,109144,15167040,408262,92.2,97.6,80.6,94.2,87.9
3601,28700,"Kingsport-Bristol, TN-VA (Metropolitan Statistical Area) *",2010,32568,108400,1904,110304,106496,10079289,309480,86.4,97.8,57.3,94.3,82.3
3602,28740,"Kingston, NY (Metropolitan Statistical Area)",2010,38245,242100,3412,245512,238688,6976549,182418,103,97.9,126.1,97.9,98.1
3603,28940,"Knoxville, TN (Metropolitan Statistical Area)",2010,34718,148100,1433,149533,146667,28329224,815984,89.5,97.2,69.4,94,85.2
3604,29020,"Kokomo, IN (Metropolitan Statistical Area)",2010,31154,109200,2416,111616,106784,2578070,82752,87.9,97.2,61,94.6,83.7
3605,29100,"La Crosse-Onalaska, WI-MN (Metropolitan Statistical Area)",2010,37944,148800,2044,150844,146756,5080533,133897,92.8,97.2,80.2,94.6,88.5
3606,29180,"Lafayette, LA (Metropolitan Statistical Area)",2010,38547,139000,2522,141522,136478,18025264,467612,87.5,96.9,63,93.7,83.3
3607,29340,"Lake Charles, LA (Metropolitan Statistical Area)",2010,34543,110000,2627,112627,107373,6906547,199943,88.3,97.7,63.5,94.3,84.2
3608,29420,"Lake Havasu City-Kingman, AZ (Metropolitan Statistical Area)",2010,25582,170600,3193,173793,167407,5124399,200314,95.8,97.1,86.1,100.2,91.2
3609,29460,"Lakeland-Winter Haven, FL (Metropolitan Statistical Area)",2010,30466,141900,2131,144031,139769,18373933,603102,94.5,97.8,89,94.3,90
3610,29540,"Lancaster, PA (Metropolitan Statistical Area)",2010,38005,184400,1589,185989,182811,19774960,520319,97.9,97.9,97.8,97.9,93.3
3611,29620,"Lansing-East Lansing, MI (Metropolitan Statistical Area)",2010,32967,148300,1473,149773,146827,17633905,534899,94.8,97.2,89.7,94.6,90.3
3612,29700,"Laredo, TX (Metropolitan Statistical Area)",2010,25914,104000,2328,106328,101672,6514045,251370,88.9,97.8,68.4,94.3,84.7
3613,29740,"Las Cruces, NM (Metropolitan Statistical Area)",2010,30196,137200,4618,141818,132582,6343985,210097,92.6,97.1,73.3,100.2,88.3
3614,29820,"Las Vegas-Henderson-Paradise, NV (Metropolitan Statistical Area)",2010,35646,257300,1859,259159,255441,69601904,1952587,101.4,97.1,114.1,100.2,96.6
3615,29940,"Lawrence, KS (Metropolitan Statistical Area)",2010,33818,176500,3711,180211,172789,3760527,111198,95.4,97.2,92.8,94.6,90.9
3616,30020,"Lawton, OK (Metropolitan Statistical Area)",2010,35617,99900,2546,102446,97354,4686111,131569,89.9,97.3,69.7,94,85.7
3617,30140,"Lebanon, PA (Metropolitan Statistical Area)",2010,36930,155900,2331,158231,153569,4936259,133664,94.8,97.9,83.2,97.9,90.3
3618,30300,"Lewiston, ID-WA (Metropolitan Statistical Area)",2010,35105,159100,2895,161995,156205,2142790,61040,91.1,99.3,70.6,94.8,86.8
3619,30340,"Lewiston-Auburn, ME (Metropolitan Statistical Area)",2010,34004,155700,2284,157984,153416,3662513,107708,95,97.9,85.2,97.9,90.5
3620,30460,"Lexington-Fayette, KY (Metropolitan Statistical Area)",2010,37141,156600,1644,158244,154956,17583206,473412,92.6,97.8,79.4,94.3,88.2
3621,30620,"Lima, OH (Metropolitan Statistical Area)",2010,32759,104800,2995,107795,101805,3484154,106358,88.6,97.2,62.4,94.6,84.4
3622,30700,"Lincoln, NE (Metropolitan Statistical Area)",2010,38590,145000,1171,146171,143829,11691240,302961,93.1,97,82.2,94.4,88.7
3623,30780,"Little Rock-North Little Rock-Conway, AR (Metropolitan Statistical Area)",2010,36858,127800,1561,129361,126239,25885178,702294,91.5,97.7,75.4,94.3,87.2
3624,30860,"Logan, UT-ID (Metropolitan Statistical Area)",2010,28255,178400,2848,181248,175552,3564862,126167,91.6,99.3,72.3,94.8,87.3
3625,30980,"Longview, TX (Metropolitan Statistical Area)",2010,36449,98800,2492,101292,96308,10223575,280487,90.8,97,74.4,93.8,86.5
3626,31020,"Longview, WA (Metropolitan Statistical Area)",2010,35282,191500,3701,195201,187799,3611372,102358,94.9,99.3,86.9,94.8,90.4
3627,31140,"Louisville/Jefferson County, KY-IN (Metropolitan Statistical Area)",2010,37846,143900,838,144738,143062,45591845,1204655,91,97.5,73.8,94.1,86.7
3628,31180,"Lubbock, TX (Metropolitan Statistical Area)",2010,33657,101600,1670,103270,99930,9835832,292241,93.5,97.5,84.3,94.2,89.1
3629,31340,"Lynchburg, VA (Metropolitan Statistical Area) *",2010,32961,150700,2068,152768,148632,8338197,252969,90.3,97.6,70.3,94.2,86
3630,31420,"Macon-Bibb County, GA (Metropolitan Statistical Area)",2010,32688,118100,3049,121149,115051,7590079,232199,87.8,97.2,64.6,94,83.7
3631,31460,"Madera, CA (Metropolitan Statistical Area)",2010,28450,276000,7962,283962,268038,4295560,150986,98,97.1,96.2,100.2,93.3
3632,31540,"Madison, WI (Metropolitan Statistical Area)",2010,43423,223000,1291,224291,221709,26341322,606625,97.2,96.4,106.7,93.9,92.7
3633,31700,"Manchester-Nashua, NH (Metropolitan Statistical Area)",2010,47609,269900,1988,271888,267912,19093904,401055,109,97.6,126.5,112.9,103.8
3634,31740,"Manhattan, KS (Metropolitan Statistical Area)",2010,39462,142900,3962,146862,138938,5071745,128521,91.8,90,99.4,87.8,87.4
3635,31860,"Mankato, MN (Metropolitan Statistical Area)",2010,34757,166000,2231,168231,163769,3365978,96844,88.9,90,88.7,87.8,84.7
3636,31900,"Mansfield, OH (Metropolitan Statistical Area)",2010,30339,112200,2116,114316,110084,3767011,124162,88.6,97.2,62.6,94.6,84.4
3637,32580,"McAllen-Edinburg-Mission, TX (Metropolitan Statistical Area)",2010,21927,73000,1293,74293,71707,17084134,779149,84,97.8,53,94.3,80
3638,32780,"Medford, OR (Metropolitan Statistical Area)",2010,33246,274500,5547,280047,268953,6760361,203341,98.6,97.1,99.2,100.2,93.9
3639,32820,"Memphis, TN-MS-AR (Metropolitan Statistical Area)",2010,36909,135200,1079,136279,134121,48627283,1317489,92,97.6,78.2,94.2,87.6
3640,32900,"Merced, CA (Metropolitan Statistical Area)",2010,28442,241000,5278,246278,235722,7301531,256721,96.5,97.1,89,100.2,91.9
3641,33100,"Miami-Fort Lauderdale-Pompano Beach, FL (Metropolitan Statistical Area)",2010,42890,260000,1228,261228,258772,239473700,5583394,105.4,99.5,130.1,98.3,100.4
3642,33140,"Michigan City-La Porte, IN (Metropolitan Statistical Area)",2010,32016,119800,2618,122418,117182,3568513,111459,85.1,90,74.6,87.8,81
3643,33220,"Midland, MI (Metropolitan Statistical Area)",2010,42719,132800,3254,136054,129546,3573452,83651,93,97.2,80,94.6,88.6
3644,33260,"Midland, TX (Metropolitan Statistical Area)",2010,72251,121200,4579,125779,116621,10243928,141783,95.2,97.6,91.3,94.2,90.7
3645,33340,"Milwaukee-Waukesha, WI (Metropolitan Statistical Area)",2010,43616,204800,1149,205949,203651,67895636,1556678,95.4,97.6,98.7,91.6,90.9
3646,33460,"Minneapolis-St. Paul-Bloomington, MN-WI (Metropolitan Statistical Area)",2010,46214,239100,492,239592,238608,154354201,3340007,102.5,101.1,109.9,100.8,97.7
3647,33540,"Missoula, MT (Metropolitan Statistical Area)",2010,34223,233700,4077,237777,229623,3746315,109467,96.1,99.3,91.9,94.8,91.5
3648,33660,"Mobile, AL (Metropolitan Statistical Area)",2010,31810,120700,1910,122610,118790,13708434,430941,88.7,97.8,65.9,94.3,84.5
3649,33700,"Modesto, CA (Metropolitan Statistical Area)",2010,32118,285200,4392,289592,280808,16545238,515145,99.9,97.1,106.2,100.2,95.1
3650,33740,"Monroe, LA (Metropolitan Statistical Area)",2010,32392,105600,3518,109118,102082,6629892,204675,86.5,97.4,56.5,94.1,82.4
3651,33780,"Monroe, MI (Metropolitan Statistical Area)",2010,34203,161800,1828,163628,159972,5196594,151936,96.5,99.4,81.3,100.8,92
3652,33860,"Montgomery, AL (Metropolitan Statistical Area)",2010,34842,124400,1830,126230,122570,13070002,375119,90.4,97.7,71.7,94.3,86.2
3653,34060,"Morgantown, WV (Metropolitan Statistical Area)",2010,34296,121400,3801,125201,117599,4469039,130308,88.1,93.2,77.8,90.8,83.9
3654,34100,"Morristown, TN (Metropolitan Statistical Area)",2010,28104,114400,2686,117086,111714,3848707,136945,82.4,93.2,62.8,90.8,78.5
3655,34580,"Mount Vernon-Anacortes, WA (Metropolitan Statistical Area)",2010,38195,278300,5147,283447,273153,4466693,116944,99.7,99.3,108.6,94.8,95
3656,34620,"Muncie, IN (Metropolitan Statistical Area)",2010,28229,92400,1920,94320,90480,3321544,117665,89.9,97.2,70.4,94.6,85.6
3657,34740,"Muskegon, MI (Metropolitan Statistical Area)",2010,28880,112800,1626,114426,111174,4964769,171913,89.7,97.2,68.2,94.6,85.4
3658,34820,"Myrtle Beach-Conway-North Myrtle Beach, SC-NC (Metropolitan Statistical Area)",2010,29911,170100,2270,172370,167830,11316565,378343,92.8,96.7,87.8,93.6,88.5
3659,34900,"Napa, CA (Metropolitan Statistical Area)",2010,46713,571500,12212,583712,559288,6388392,136759,118.3,108.7,158.2,109.3,112.7
3660,34940,"Naples-Marco Island, FL (Metropolitan Statistical Area)",2010,62567,357400,5929,363329,351471,20182883,322581,100.5,97.8,123.5,94.3,95.8
3661,34980,"Nashville-Davidson--Murfreesboro--Franklin, TN (Metropolitan Statistical Area)",2010,41763,170200,867,171067,169333,68943418,1650831,94.1,97.5,87.3,94.2,89.6
3662,35100,"New Bern, NC (Metropolitan Statistical Area)",2010,35889,144300,3958,148258,140342,4573112,127423,85,93.2,71,90.8,80.9
3663,35300,"New Haven-Milford, CT (Metropolitan Statistical Area)",2010,44925,273300,1644,274944,271656,38786438,863357,114.1,108.8,119.5,116.4,108.7
3664,35380,"New Orleans-Metairie, LA (Metropolitan Statistical Area)",2010,42609,178900,1239,180139,177661,50931119,1195324,97.8,97.6,104.8,94.2,93.2
3665,35620,"New York-Newark-Jersey City, NY-NJ-PA (Metropolitan Statistical Area)",2010,54632,448500,708,449208,447792,1033820797,18923407,122.2,108.1,155.4,119.3,116.4
3666,35660,"Niles, MI (Metropolitan Statistical Area)",2010,36122,135600,2273,137873,133327,5661580,156737,90.4,97.2,69.9,94.6,86.2
3667,35840,"North Port-Sarasota-Bradenton, FL (Metropolitan Statistical Area)",2010,41702,226300,2190,228490,224110,29331427,703354,99.5,97.8,111.9,94.3,94.8
3668,35980,"Norwich-New London, CT (Metropolitan Statistical Area)",2010,46409,268900,3676,272576,265224,12716139,274004,101.5,97.9,117.1,97.9,96.7
3669,36100,"Ocala, FL (Metropolitan Statistical Area)",2010,30073,150700,2111,152811,148589,9964115,331331,93.4,97.8,85,94.3,89
3670,36140,"Ocean City, NJ (Metropolitan Statistical Area)",2010,44690,337300,6405,343705,330895,4344431,97212,108.6,105,112.8,110,103.5
3671,36220,"Odessa, TX (Metropolitan Statistical Area)",2010,34961,75500,2332,77832,73168,4792296,137075,92.7,97.8,78.3,94.3,88.4
3672,36260,"Ogden-Clearfield, UT (Metropolitan Statistical Area)",2010,32213,200100,1957,202057,198143,19319224,599740,96.3,97.3,87.7,99.8,91.8
3673,36420,"Oklahoma City, OK (Metropolitan Statistical Area)",2010,38712,121300,815,122115,120485,48691611,1257793,91.8,97.6,76.2,94.2,87.5
3674,36500,"Olympia-Lacey-Tumwater, WA (Metropolitan Statistical Area)",2010,40535,257800,3225,261025,254575,10255275,253001,104.7,105.1,111.3,101.1,99.8
3675,36540,"Omaha-Council Bluffs, NE-IA (Metropolitan Statistical Area)",2010,44912,143400,658,144058,142742,38968526,867671,94.1,97,86.6,94.4,89.6
3676,36740,"Orlando-Kissimmee-Sanford, FL (Metropolitan Statistical Area)",2010,33258,219400,1150,220550,218250,71145046,2139161,99.1,97.8,109.5,94.3,94.4
3677,36780,"Oshkosh-Neenah, WI (Metropolitan Statistical Area)",2010,37175,140500,1609,142109,138891,6210926,167073,92.6,97.2,78.5,94.6,88.2
3678,36980,"Owensboro, KY (Metropolitan Statistical Area)",2010,35168,100700,2764,103464,97936,4036253,114770,86.6,97.3,59.1,94,82.5
3679,37100,"Oxnard-Thousand Oaks-Ventura, CA (Metropolitan Statistical Area)",2010,45912,568700,4202,572902,564498,37882017,825097,115.1,98.8,171,103.5,109.6
3680,37340,"Palm Bay-Melbourne-Titusville, FL (Metropolitan Statistical Area)",2010,36715,186900,1680,188580,185220,19971497,543965,96.9,97.8,99.2,94.3,92.3
3681,37460,"Panama City, FL (Metropolitan Statistical Area)",2010,36768,175500,3541,179041,171959,6221309,169206,95.8,97.2,95.9,94,91.2
3682,37620,"Parkersburg-Vienna, WV (Metropolitan Statistical Area)",2010,32374,103600,2280,105880,101320,3001028,92698,88.1,97.6,60.7,94.2,83.9
3683,37860,"Pensacola-Ferry Pass-Brent, FL (Metropolitan Statistical Area)",2010,35036,159300,1698,160998,157602,15799407,450946,94.3,97.8,88.1,94.3,89.8
3684,37900,"Peoria, IL (Metropolitan Statistical Area)",2010,39116,123500,1311,124811,122189,16274373,416051,91.7,97,73.4,94.4,87.3
3685,37980,"Philadelphia-Camden-Wilmington, PA-NJ-DE-MD (Metropolitan Statistical Area)",2010,48155,243300,591,243891,242709,287527441,5970899,108.7,105,113.5,110,103.6
3686,38060,"Phoenix-Mesa-Chandler, AZ (Metropolitan Statistical Area)",2010,34959,232300,831,233131,231469,146975844,4204204,100.8,101.4,104.5,98.4,96.1
3687,38220,"Pine Bluff, AR (Metropolitan Statistical Area)",2010,27844,74900,2272,77172,72628,2787368,100107,84.5,97.1,52.3,93.9,80.5
3688,38300,"Pittsburgh, PA (Metropolitan Statistical Area)",2010,42856,117900,580,118480,117320,101016521,2357090,93,95,76.5,98.3,88.6
3689,38340,"Pittsfield, MA (Metropolitan Statistical Area)",2010,41267,207800,5124,212924,202676,5419023,131317,96.7,97.9,92.1,97.9,92.1
3690,38540,"Pocatello, ID (Metropolitan Statistical Area)",2010,29221,134700,2689,137389,132011,2655918,90892,91.6,99.3,73.6,94.8,87.2
3691,38860,"Portland-South Portland, ME (Metropolitan Statistical Area)",2010,43287,238600,1632,240232,236968,22245639,513911,100.5,97.9,108.7,99.2,95.8
3692,38900,"Portland-Vancouver-Hillsboro, OR-WA (Metropolitan Statistical Area)",2010,39940,286300,1152,287452,285148,89153740,2232181,100.1,97.2,108.2,100.4,95.4
3693,38940,"Port St. Lucie, FL (Metropolitan Statistical Area)",2010,38555,198600,3074,201674,195526,16392581,425173,97.5,97.8,102,94.3,92.9
3694,39100,"Poughkeepsie-Newburgh-Middletown, NY (Metropolitan Statistical Area)",2010,40911,317500,2312,319812,315188,27458091,671173,(NA),(NA),(NA),(NA),(NA)
3695,39300,"Providence-Warwick, RI-MA (Metropolitan Statistical Area)",2010,42183,288700,1041,289741,287659,67625238,1603125,99.8,97.9,101.6,100.9,95.1
3696,39340,"Provo-Orem, UT (Metropolitan Statistical Area)",2010,26272,232200,1765,233965,230435,13930915,530262,97.9,97.2,95.9,100.1,93.3
3697,39380,"Pueblo, CO (Metropolitan Statistical Area)",2010,29620,140700,2369,143069,138331,4721180,159390,93.1,97.1,75.2,100.2,88.7
3698,39460,"Punta Gorda, FL (Metropolitan Statistical Area)",2010,32053,184900,3809,188709,181091,5124528,159875,95.8,97.8,94.7,94.3,91.3
3699,39540,"Racine, WI (Metropolitan Statistical Area)",2010,38024,175700,2568,178268,173132,7430040,195406,93.2,97.6,86.4,91.6,88.8
3700,39580,"Raleigh-Cary, NC (Metropolitan Statistical Area)",2010,42830,197400,1524,198924,195876,48714028,1137383,95.3,97.8,91.8,94.3,90.8
3701,39660,"Rapid City, SD (Metropolitan Statistical Area)",2010,39936,148800,2663,151463,146137,5060920,126727,90.3,95.6,74.5,93.2,86
3702,39740,"Reading, PA (Metropolitan Statistical Area)",2010,38094,170400,1770,172170,168630,15696057,412039,96.3,97.9,89.8,97.9,91.7
3703,39820,"Redding, CA (Metropolitan Statistical Area)",2010,34622,267600,5844,273444,261756,6137606,177274,98.9,97.1,101,100.2,94.3
3704,39900,"Reno, NV (Metropolitan Statistical Area)",2010,43530,295200,4938,300138,290262,18541496,425951,100.7,97.1,111,100.2,95.9
3705,40060,"Richmond, VA (Metropolitan Statistical Area) *",2010,42934,225200,1190,226390,224010,51016738,1188246,96.7,97.6,99.3,94.2,92.1
3706,40140,"Riverside-San Bernardino-Ontario, CA (Metropolitan Statistical Area)",2010,30154,322300,1619,323919,320681,127926884,4242424,107.7,98.8,128,103.5,102.6
3707,40220,"Roanoke, VA (Metropolitan Statistical Area) *",2010,37724,164800,1930,166730,162870,11641321,308589,91.9,97.2,78.9,93.9,87.5
3708,40340,"Rochester, MN (Metropolitan Statistical Area)",2010,42697,171100,1750,172850,169350,8847715,207222,93.7,95.4,90.8,93.1,89.3
3709,40380,"Rochester, NY (Metropolitan Statistical Area)",2010,39592,124300,684,124984,123616,42758125,1079974,97.4,97.9,95.4,97.9,92.8
3710,40420,"Rockford, IL (Metropolitan Statistical Area)",2010,33884,134500,1365,135865,133135,11831811,349184,91.9,97.2,76.4,94.6,87.5
3711,40580,"Rocky Mount, NC (Metropolitan Statistical Area)",2010,31984,99800,3055,102855,96745,4874454,152405,86.5,97.8,57.3,94.3,82.4
3712,40660,"Rome, GA (Metropolitan Statistical Area)",2010,30256,118300,3557,121857,114743,2917603,96431,81.8,93.2,62,90.8,77.9
3713,40900,"Sacramento-Roseville-Folsom, CA (Metropolitan Statistical Area)",2010,41131,357700,1314,359014,356386,88581303,2153613,103.2,97.1,126,100.2,98.3
3714,40980,"Saginaw, MI (Metropolitan Statistical Area)",2010,30518,110000,1928,111928,108072,6099417,199862,90,97.2,68,94.6,85.7
3715,41060,"St. Cloud, MN (Metropolitan Statistical Area)",2010,34455,173600,1639,175239,171961,6519588,189218,92.2,97.2,79.4,94.6,87.9
3716,41100,"St. George, UT (Metropolitan Statistical Area)",2010,26029,240900,4333,245233,236567,3602106,138389,96.1,99.3,92.3,94.8,91.5
3717,41140,"St. Joseph, MO-KS (Metropolitan Statistical Area)",2010,31213,109300,2456,111756,106844,3972526,127271,88.2,96.5,63.5,94,84
3718,41180,"St. Louis, MO-IL (Metropolitan Statistical Area)",2010,42432,159800,618,160418,159182,118383785,2789989,89.2,90.9,83.7,89.8,84.9
3719,41420,"Salem, OR (Metropolitan Statistical Area)",2010,31464,209800,2458,212258,207342,12317582,391479,96.8,97.2,88.7,100.4,92.2
3720,41500,"Salinas, CA (Metropolitan Statistical Area)",2010,41462,566300,8719,575019,557581,17263664,416373,107.2,97.1,152,100.2,102.1
3721,41540,"Salisbury, MD-DE (Metropolitan Statistical Area)",2010,36383,188900,3844,192744,185056,13636949,374821,89.2,93.2,82.9,90.8,85
3722,41620,"Salt Lake City, UT (Metropolitan Statistical Area)",2010,36047,237200,1194,238394,236006,39344828,1091478,99.5,97.2,104.3,100,94.8
3723,41660,"San Angelo, TX (Metropolitan Statistical Area)",2010,36793,88300,2460,90760,85840,4173139,113422,92.1,97.7,77.8,94.3,87.8
3724,41700,"San Antonio-New Braunfels, TX (Metropolitan Statistical Area)",2010,35873,122200,735,122935,121465,77233922,2153009,93.8,97.5,86.2,94.2,89.4
3725,41740,"San Diego-Chula Vista-Carlsbad, CA (Metropolitan Statistical Area)",2010,44138,486000,1855,487855,484145,136969778,3103212,118.3,104.9,169,103.1,112.7
3726,41860,"San Francisco-Oakland-Berkeley, CA (Metropolitan Statistical Area)",2010,61240,655000,1941,656941,653059,266002196,4343634,121.1,108.7,183.5,109.3,115.4
3727,41940,"San Jose-Sunnyvale-Santa Clara, CA (Metropolitan Statistical Area)",2010,60565,696200,3125,699325,693075,111534137,1841556,121.4,108.5,189.2,109,115.7
3728,42020,"San Luis Obispo-Paso Robles, CA (Metropolitan Statistical Area)",2010,40234,513900,10595,524495,503305,10855099,269802,107.3,97.1,152.3,100.2,102.2
3729,42100,"Santa Cruz-Watsonville, CA (Metropolitan Statistical Area)",2010,48619,648700,8084,656784,640616,12794043,263147,120.1,108.7,164.8,109.3,114.4
3730,42140,"Santa Fe, NM (Metropolitan Statistical Area)",2010,43253,291700,5540,297240,286160,6250949,144522,98.8,97.1,100.8,100.2,94.2
3731,42220,"Santa Rosa-Petaluma, CA (Metropolitan Statistical Area)",2010,42971,524400,5801,530201,518599,20830579,484755,118.1,108.7,153,109.3,112.6
3732,42340,"Savannah, GA (Metropolitan Statistical Area)",2010,37546,173100,2590,175690,170510,13089864,348640,95,97.8,91.1,94.3,90.5
3733,42540,"Scranton--Wilkes-Barre, PA (Metropolitan Statistical Area)",2010,36497,122300,1160,123460,121140,20574826,563740,91.2,97.9,68.5,97.9,86.9
3734,42660,"Seattle-Tacoma-Bellevue, WA (Metropolitan Statistical Area)",2010,48796,358000,1087,359087,356913,168310441,3449241,107.4,105.1,129,101.1,102.4
3735,42680,"Sebastian-Vero Beach, FL (Metropolitan Statistical Area)",2010,52733,198200,4798,202998,193402,7291344,138270,93.5,93.2,97,90.8,89.1
3736,42700,"Sebring-Avon Park, FL (Metropolitan Statistical Area)",2010,28785,122000,3955,125955,118045,2839216,98635,86.9,93.2,77.5,90.8,82.8
3737,43100,"Sheboygan, WI (Metropolitan Statistical Area)",2010,38881,151100,2060,153160,149040,4491663,115524,91.5,97.2,73.8,94.6,87.2
3738,43300,"Sherman-Denison, TX (Metropolitan Statistical Area)",2010,32264,99600,2770,102370,96830,3904991,121034,91.2,97.8,73.8,94.3,86.9
3739,43340,"Shreveport-Bossier City, LA (Metropolitan Statistical Area)",2010,39263,115500,2298,117798,113202,15702599,399935,90.3,97.6,70.3,94.2,86.1
3740,43420,"Sierra Vista-Douglas, AZ (Metropolitan Statistical Area)",2010,34563,154900,4066,158966,150834,4556212,131822,92.8,99.3,78.6,94.8,88.4
3741,43580,"Sioux City, IA-NE-SD (Metropolitan Statistical Area)",2010,40812,96200,1298,97498,94902,5872816,143901,88.8,94.5,67.6,92.4,84.6
3742,43620,"Sioux Falls, SD (Metropolitan Statistical Area)",2010,46356,146700,1532,148232,145168,10620149,229099,93.4,97,82.9,94.4,89
3743,43780,"South Bend-Mishawaka, IN-MI (Metropolitan Statistical Area)",2010,34202,119200,1570,120770,117630,10911871,319044,90.8,96.4,75,93.9,86.5
3744,43900,"Spartanburg, SC (Metropolitan Statistical Area)",2010,32023,116300,1999,118299,114301,9117819,284731,88.2,97.5,65.4,94.2,84.1
3745,44060,"Spokane-Spokane Valley, WA (Metropolitan Statistical Area)",2010,34744,187900,1790,189690,186110,17912195,515553,95.9,97.4,85.9,99.3,91.4
3746,44100,"Springfield, IL (Metropolitan Statistical Area)",2010,39226,118600,1790,120390,116810,8255598,210465,92.8,97.2,76.8,94.6,88.4
3747,44140,"Springfield, MA (Metropolitan Statistical Area)",2010,39390,218000,1453,219453,216547,27373425,694935,96.8,97.9,92.6,98,92.2
3748,44180,"Springfield, MO (Metropolitan Statistical Area)",2010,31955,127600,1406,129006,126194,13975534,437349,89.5,96.8,69.3,94.2,85.3
3749,44220,"Springfield, OH (Metropolitan Statistical Area)",2010,32187,109900,1670,111570,108230,4450591,138274,89.3,97.2,65.4,94.6,85.1
3750,44300,"State College, PA (Metropolitan Statistical Area)",2010,35703,175800,3798,179598,172002,5506441,154230,100.6,97.9,111.2,97.9,95.8
3751,44420,"Staunton, VA (Metropolitan Statistical Area) *",2010,35988,179200,3603,182803,175597,4257939,118314,87,93.2,75.5,90.8,82.9
3752,44700,"Stockton, CA (Metropolitan Statistical Area)",2010,32757,318600,4078,322678,314522,22508045,687127,101.6,97.1,115.8,100.2,96.8
3753,44940,"Sumter, SC (Metropolitan Statistical Area)",2010,28496,98800,2851,101651,95949,4062238,142555,87.9,97.8,63.9,94.3,83.8
3754,45060,"Syracuse, NY (Metropolitan Statistical Area)",2010,38028,115600,1097,116697,114503,25216437,663110,95.5,97.9,86.4,97.9,91
3755,45220,"Tallahassee, FL (Metropolitan Statistical Area)",2010,34667,175200,2895,178095,172305,12804173,369345,95.1,97.4,92.3,94.1,90.6
3756,45300,"Tampa-St. Petersburg-Clearwater, FL (Metropolitan Statistical Area)",2010,38418,182400,1167,183567,181233,107124316,2788366,99.9,97.9,108.3,97.1,95.2
3757,45460,"Terre Haute, IN (Metropolitan Statistical Area)",2010,30611,85900,1644,87544,84256,5801484,189523,88.1,96.6,61.5,94.1,83.9
3758,45500,"Texarkana, TX-AR (Metropolitan Statistical Area)",2010,31918,87800,2315,90115,85485,4766345,149332,88,97,61.4,93.8,83.8
3759,45540,"The Villages, FL (Metropolitan Statistical Area)",2010,29758,184000,4061,188061,179939,2805571,94278,83,93.2,71.6,90.8,79.1
3760,45780,"Toledo, OH (Metropolitan Statistical Area)",2010,35679,131000,1125,132125,129875,23240294,651372,90,97.2,68.6,94.6,85.7
3761,45820,"Topeka, KS (Metropolitan Statistical Area)",2010,36522,114900,1356,116256,113544,8555962,234266,90,96,71.6,93.5,85.7
3762,45940,"Trenton-Princeton, NJ (Metropolitan Statistical Area)",2010,53251,309300,4204,313504,305096,19581226,367713,112.2,99.8,128.3,117.3,106.9
3763,46060,"Tucson, AZ (Metropolitan Statistical Area)",2010,34070,198300,1651,199951,196649,33444170,981620,97.6,97.1,94.2,100.2,92.9
3764,46140,"Tulsa, OK (Metropolitan Statistical Area)",2010,41344,121900,1044,122944,120856,38856275,939833,91.1,97.6,72.9,94.2,86.8
3765,46220,"Tuscaloosa, AL (Metropolitan Statistical Area)",2010,31547,138800,2425,141225,136375,7554904,239481,88.4,96.9,65.8,93.8,84.2
3766,46300,"Twin Falls, ID (Metropolitan Statistical Area)",2010,29625,146000,3212,149212,142788,2962142,99987,(NA),(NA),(NA),(NA),(NA)
3767,46340,"Tyler, TX (Metropolitan Statistical Area)",2010,42092,118000,2906,120906,115094,8856467,210408,94.8,97.8,88.8,94.3,90.3
3768,46540,"Utica-Rome, NY (Metropolitan Statistical Area)",2010,35395,98200,1119,99319,97081,10591169,299226,92.5,97.9,73.4,97.9,88.2
3769,46660,"Valdosta, GA (Metropolitan Statistical Area)",2010,28974,119600,3591,123191,116009,4057869,140054,84.2,93.2,68.5,90.8,80.2
3770,46700,"Vallejo, CA (Metropolitan Statistical Area)",2010,37721,389800,4669,394469,385131,15615400,413967,117.1,108.7,146.5,109.3,111.6
3771,47020,"Victoria, TX (Metropolitan Statistical Area)",2010,36347,96900,2677,99577,94223,3420315,94102,90.8,97.5,71.9,94.1,86.5
3772,47220,"Vineland-Bridgeton, NJ (Metropolitan Statistical Area)",2010,33496,175500,3398,178898,172102,5248781,156699,103.2,105,90.6,110,98.3
3773,47260,"Virginia Beach-Norfolk-Newport News, VA-NC (Metropolitan Statistical Area) *",2010,40466,244200,1276,245476,242924,69481881,1717036,99.2,97.7,111,94.3,94.6
3774,47300,"Visalia, CA (Metropolitan Statistical Area)",2010,30475,211200,2917,214117,208283,13499399,442969,96.1,97.1,87.1,100.2,91.6
3775,47380,"Waco, TX (Metropolitan Statistical Area)",2010,31225,101000,2309,103309,98691,7925194,253808,90.6,97.3,72.6,94,86.3
3776,47460,"Walla Walla, WA (Metropolitan Statistical Area)",2010,34788,195200,6047,201247,189153,2049529,58915,94.3,99.3,82.9,94.6,89.8
3777,47580,"Warner Robins, GA (Metropolitan Statistical Area)",2010,34537,132500,3228,135728,129272,5819814,168508,89.2,97.3,66.7,94,85
3778,47900,"Washington-Arlington-Alexandria, DC-VA-MD-WV (Metropolitan Statistical Area) *",2010,58408,416600,1318,417918,415282,331670527,5678491,120.7,106.9,165,112.8,115
3779,47940,"Waterloo-Cedar Falls, IA (Metropolitan Statistical Area)",2010,35954,120000,1583,121583,118417,6037465,167920,90.5,95.9,74.3,93.4,86.3
3780,48060,"Watertown-Fort Drum, NY (Metropolitan Statistical Area)",2010,41382,116800,2711,119511,114089,4824770,116592,97.1,97.9,94.6,97.9,92.5
3781,48140,"Wausau-Weston, WI (Metropolitan Statistical Area)",2010,36905,139500,1777,141277,137723,6009220,162829,92.3,97.2,76,94.6,88
3782,48300,"Wenatchee, WA (Metropolitan Statistical Area)",2010,34151,229700,5839,235539,223861,3799818,111264,96.7,99.3,94.3,94.8,92.1
3783,48540,"Wheeling, WV-OH (Metropolitan Statistical Area)",2010,32889,85600,1334,86934,84266,4864275,147899,85.5,97.8,51.4,94.3,81.5
3784,48620,"Wichita, KS (Metropolitan Statistical Area)",2010,38784,115000,1089,116089,113911,24196893,623887,91,96.9,71.6,94.4,86.7
3785,48660,"Wichita Falls, TX (Metropolitan Statistical Area)",2010,37573,86700,1599,88299,85101,5697899,151649,90.8,97.5,73.7,94.2,86.5
3786,48700,"Williamsport, PA (Metropolitan Statistical Area)",2010,34170,119200,2126,121326,117074,3971445,116225,91,97.9,69,97.9,86.7
3787,48900,"Wilmington, NC (Metropolitan Statistical Area)",2010,34196,205500,2917,208417,202583,8743765,255699,94.9,97.2,92.3,93.9,90.4
3788,49020,"Winchester, VA-WV (Metropolitan Statistical Area) *",2010,36597,228500,4860,233360,223640,4708233,128652,91.7,93.2,90.6,90.8,87.4
3789,49180,"Winston-Salem, NC (Metropolitan Statistical Area)",2010,35660,143400,1288,144688,142112,22866797,641245,90.2,97.8,70,94.3,85.9
3790,49340,"Worcester, MA-CT (Metropolitan Statistical Area)",2010,42926,282800,1742,284542,281058,39446298,918935,104.5,97.6,105.2,111.9,99.5
3791,49420,"Yakima, WA (Metropolitan Statistical Area)",2010,32055,149700,2689,152389,147011,7829612,244256,94.8,97.1,80.2,100.2,90.3
3792,49620,"York-Hanover, PA (Metropolitan Statistical Area)",2010,40278,175500,1839,177339,173661,17537523,435413,95.5,97.9,86.5,97.9,91
3793,49660,"Youngstown-Warren-Boardman, OH-PA (Metropolitan Statistical Area)",2010,32914,100400,1164,101564,99236,18590681,564826,88.5,97.4,61.5,95.3,84.4
3794,49700,"Yuba City, CA (Metropolitan Statistical Area)",2010,33442,246100,5135,251235,240965,5588084,167099,98.3,97.1,97.8,100.2,93.6
3795,49740,"Yuma, AZ (Metropolitan Statistical Area) *",2010,27236,142400,4510,146910,137890,5368937,197127,94.2,97.1,79.9,100.2,89.7
